                                                                                
                                                                                
                                                                                
                                                                                
                                                                                
                                                                                
                                                                                
                     -------------                                              
           ----------#############-                                             
          -#########-#############-                                             
          -#########-####++#######-                                             
          -#########-#############-                                             
          -#######################-                                             
          -#######################-                                             
          -#############++#+######-                                             
          -###+++###-######+######-                                             
          -#########-#############-                                             
          -#########-#############-                                             
           ----------#############-                                             
                    -#############-                                             
                    -#############-                                             
                     -----###------ ---------                                   
          ----------------#########-#########-                                  
         -###############-#########-#########-                                  
         -###############-#########-#########-                                  
         -#####++########-###################-                                  
         -###############-###################-                                  
         -###############-###################-                                  
         -###############-###+++###-#########-                                  
         -#########################-#########-                                  
         -#########################-#########-                                  
         -##+++##########--------------###-----                                 
         -##+###+#+######-     -###############-                                
         -######+#+###+++-     -###############-                                
         -###############-     -###############-                                
         -###############-     -###############-                                
         -###############-     -###############-                                
         -###############-     -###############-                                
          --------###----      -###############-                                
              -#########-      -#######S#######-                                
              -#########-      -##+++##########-                                
              -#########-      -##+###+#+###+##-                                
              -#########-      -######+#+###+++-                                
              -#########-      -###############-                                
              -#########-      -#####++########-                                
              -#########-      -###############-                                
              -#########-      -###############-                                
              -#########-       ---------------                                 
               -----###-----                                                    
              -#############-                                                   
              -#############-                                                   
              -#############-                                                   
              -#############-                                                   
              -#############-                                                   
              -#############-                                                   
              -###++#+######-                                                   
              -######+######-                                                   
              -#############-                                                   
              -#############-                                                   
              -#############-                                                   
              -#############-                                                   
              -#############-                                                   
               -------ttt---                                                    
                  -#########-                                                   
                  -#########-                                                   
                  -#########-                                                   
                  -#########-                                                   
                  -####G####-                                                   
                  -#########-                                                   
                  -#########-                                                   
                  -#########-                                                   
                  -#########-                                                   
                   ---------                                                    
                                                                                
                                                                                
                                                                                
                                                                                
                                                                                
                                                                                
                                                                                
