00000000000000000000000000000000000000000000000000000000000000000000000000000000
00000000000000000000000000000000000000000000000000000000000000000000000000000000
00000000000000000000000000000000000000000000000000000000000000000000000000000000
00000000000000000000000000000000000000000000000000000000000000000000000000000000
00000000000000000000000000000000000000000000000000000000000000000000000000000000
00000000000000000000000000000000000000000000000000000000000000000000000000000000
00000000000000000000000000000000000000000000000000000000000000000000000000000000
00000000000000000000000000000000000000000000000000000000000000000000000000000000
00000000000000000000000000000000000000000000000000000000000000000000000000000000
00000000000000000000000000000000000000000000000000000000000000000000000000000000
00000000000000000000000000000000000000000000000000000000000000000000000000000000
00000000000000000000000000000000000000000000000000000000000000000000000000000000
00000000000000000000000000000000000000000000000000000000000000000000000000000000
00000000000000000000000000000000000000000000000000000000000000000000000000000000
00000000000000000000000000000000000000000000000000000000000000000000000000000000
00000000000000000000000000000000000000000000000000000000000000000000000000000000
00000000000000000000000000000000000000000000000000000000000000000000007777777770
00000000000000000000000000000000000000000000000000000000000000000000077777777777
00000000000000000000000000000000000000000000000000000000000000000000077777777777
00000000000000000000000000000000000000000000000000000000666666666666677777777777
00000000000000000000000000000000000000000000000000000006666666666666667777777777
00000000000000000000000000000000000000000000000000000007666666666666667777777777
00000000000000000000000000000000000000000000000000000006666666666666667777777777
00000000000000000000000000000000000000000000000000000006666666666666677777777777
00000000000000000000000000000000000000000000000000000006666666666666677777777777
00000000000000000000000000000000000000000000000000000006666666666666677777777777
00000000000000000000000000000000000000000000000000000006666666666666677777777770
00000000000000000000000000000000000000000000000000000006666666666666670000000000
00000000000000000000000000000000000000000000000000000006666666666666670000000000
00000000000000000000000000000000000000000000000000000006666666666666670000000000
00000000000000000000000000000000000000000000000000000006666666666666670000000000
00000000000000000000000000000000000000000000000000000006666666666666670000000000
00000000000000000000000000000000000000000000000000000006666666666666670000000000
00000000000000000000000000000000000000000000000000000000666663336666666600000000
00000000000000000000000000000000000111111111000000000000333333333333333330000000
00000000000000000000000000000000001111111111200000000000333333333333333330000000
00000000000000000000000000000000001111111111222222222222333333333333333330000000
00000000000000000000000000000000001111111111222222222222333333333333333330000000
00000000000000000000000000000000001111111111222222222222333333333333333330000000
00000000000000000000000000000000001111111111222222222222333333333333333330000000
00000000000000000000000000000000001111111111222222222222233333333333333330000000
00000000000000000000000000000000001111111111122222222222233333333333333330000000
00000000000000000000000000000000002111111111122222222222233333333333333330000000
00000000000000000000000000000000001111111111122222222222333333333333333330000000
00000000000000000000000000000000000111111111222222222222333333333333333330000000
00000000000000000000000000000000000000000000222222222222333333333333333330000000
00000000000000000000000000000000000000000000222222222222333333333333333330000000
00000000000000000000000000000000000000000000222222222222333333333333333330000000
00000000000000000000000000000000000000000000022222222222333333333333333330000000
00000000000000000000000000000000000000000000000000844444433444444444444400000000
00000000000000000000000000000000000000000000000009444444444444444500000000000000
00000000000000000000000000000000000000000000000009444444444444444500000000000000
00000000000000000000000000000000000000000000000009444444444444444500000000000000
00000000000000000000000000000000000000009999999999444444444444444555555555555550
00000000000000000000000000000000000000099999999999444444444444444555555555555555
00000000000000000000000000000000000000099999999999444444444444444555555555555555
00000000000000000000000000000000000000099999999999444444444444444555555555555555
00000000000000000000000000000000000000099999999994444444444444444555555555555555
00000000000000000000000000000000000000099999999994444444444444444555555555555555
00000000000000000000000000000000000000099999999994444444444444444455555555555555
00000000000000000000000000000000000000099999999999444444444444444455555555555555
00000000000000000000000000000000000000099999999999444444444444444455555555555555
00000000000000000000000000000000000000099999999999444444444444444555555555555555
00000000000000000000000000000000000000009999999999444444444444444555555555555555
00000000000000000000000000000000000000000000000009444444444444444555555555555555
00000000000000000000000000000000000000000000088888448888888888888555555555555555
00000000000000000000000000000000000000000000888888888888800000000555555555555555
00000000000000000000000000000000000000000000888888888888800000000055555555555550
00000000000000000000000000000000000000000000888888888888800000000000000000000000
00000000000000000000000000000000000000000000888888888888800000000000000000000000
00000000000000000000000000000000000000000000888888888888800000000000000000000000
00000000000000000000000000000000000000000000888888888888800000000000000000000000
00000000000000000000000000000000000000000000888888888888800000000000000000000000
00000000000000000000000000000000000000000000888888888888800000000000000000000000
00000000000000000000000000000000000000000000888888888888800000000000000000000000
00000000000000000000000000000000000000000000888888888888800000000000000000000000
00000000000000000000000000000000000000000000888888888888800000000000000000000000
00000000000000000000000000000000000000000000088888888888000000000000000000000000
00000000000000000000000000000000000000000000000000000000000000000000000000000000
00000000000000000000000000000000000000000000000000000000000000000000000000000000
