00000000000000000000000000000000000000000000000000000000000000000000000000000000
00000000000000000000000000000000000000000000000000000000000000000000000000000000
00000000000000000000000000000000000000000000000000000000000000000000000000000000
00000000000000000000000000000000000000000000000000000000000000000000000000000000
00000000000000000000000000000000000000000000000000000000000000000000000000000000
00000000000000000000000000000000000000000000000000000000000000000000000000000000
00000000000000000000000000000000000000000000000000000000000000000000000000000000
00000000000000000000000000000000000000000000000000000000000000000000000000000000
00000000000000000000000000000000000000000000000000000000000000000000000000000000
00000000000000000000000000000000000000000000000000000000000000000000000000000000
00000000000000000000000000000000000000000000000000000000000000000000000000000000
00000000000000000000000000000000000000000000000000000000000000000000000000000000
00000000000000000000000000000000000000000000000000000000000000000000000000000000
00000000000000000000000000000000000000000000000000000000000000000000000000000000
00000000000000000000000000000000000000000000000000000000000000000000000000000000
00000000000000000000000000000000000000000000000000000000000000000000000000000000
00000000000000000000000000000000000000000000000000000000000000000000000000000000
00000000000000000000000000000000000000000000000000000000000000000000000000000000
00000000000000000000000000000000000000000000000000000000000000000000000000000000
00000000000000000000000000000000000000000000000000000000000000000000000000000000
00000000000000000000000000000000000000000000000000000000000000000000000000000000
00000000000000000000000000000000000000000000000000000000000000000000000000000000
00000000000000000000000000000000000000000000000000000000000000000000000000000000
00000000000000000000000000000000000000000000000000000000000000000000000000000000
00000000000000000000000000000000000000000000000000000000000000000000000000000000
00000000000000000000000000000000000000000000000000000000000000000000000000000000
00000000000000000000000000000000000000000000000000000000000000000000000000000000
00000000000000000000000000000000000000000000000000000000000000000000000000000000
00000000000000000000000000000000000000000000000000000000000000000000000000000000
00000000000000000000000000000000000000000000000000000000000000000000000000000000
00000000000000000000000000000000000000000000000000000000000000000000000000000000
00000000000000000000000000000000000000000000000000000000000000000000000000000000
00000000000000000000000000000000000000000000000000000000000000000000000000000000
00000000000000000000000000000000002111111111100000000000000000000000000000000000
00000000000000000000000000000000011111111111110000000000000000000000000000000000
00000000000000000000000000000000011111111111110000000000000000000000000000000000
00000000000000000000000000000000011111111111110000000000000000000000000000000000
00000000000000000000000000000000011111111111110000000000000000000000000000000000
00000000000000000000000000000000011111111111110000000000008888888888888000000000
00000000000000000000000000000000011111111111110000000000088888888888888800000000
00000000000000000000000000000000011111111111110000000000088888888888888800000000
00000000000000000000000000000000011111111111110000000000088888888888888800000000
00000000000000000000000000000000011111111111110000000000088888888888888800000000
00000000000000000000000000000000011111111111110000000000088888888888888800000000
00000000000000000000000000000000011111111111110000000000088888888888888800000000
00000000000000000000000000000022221132222222200000000000088888888888888800000000
00000000000000004444464444444422222222220000000000000000088888888888888800000000
00000000000000044444444444444422222222220000000000000000088888888888888800000000
00000000000000044444444444444422222222220000000000000000088888888888888800000000
00000000000000044444444444444422222222220000000000000000088888888888888800000000
00000000000000044444444444444422222222220000000000000000088888888888888800000000
00000000000000044444444444444422222222220000000000000000088888888888888800000000
00000000000000044444444444444222222222220000000000000000008888877788888000000000
00000000000000044444444444444222222222240000000000000000007777777777700000000000
00000000000000044444444444444222222222220000000000000000007777777777700000000000
00000000000000044444444444444433393222333305555555555555557777777777700000000000
00000000000000044444444444444433333333333355555555555555555777777777700000000000
00000000000000044444444444444433333333333375555555555555555777777777700000000000
00000000000000044444444444444433333333333355555555555555555777777777700000000000
00000000000000044444444444444433333333333355555555555555557777777777700000000000
00000000000000006666444666666033333333333355555555555555557777777777700000000000
00000000000000066666666666660033333333333355555555555555557777777777700000000000
00000000000000066666666666660033333333333335555555555555557777778777000000000000
00000000000000066666666666660053333333333335555555555555557000000000000000000000
00000000000000066666666666660033333333333335555555555555557000000000000000000000
00000000000000066666666666660033333333333355555555555555557000000000000000000000
00000000000000066666666666660033333333333355555555555555557000000000000000000000
00000000000000066666666666660999333999999955555555555555557000000000000000000000
00000000000000066666666666669999999999900055555555555555557000000000000000000000
00000000000000066666666666669999999999900055555555555555557000000000000000000000
00000000000000066666666666669999999999900055555555555555557000000000000000000000
00000000000000066666666666669999999999900005555555555555550000000000000000000000
00000000000000006666666666609999999999900000000000000000000000000000000000000000
00000000000000000000000000009999999999900000000000000000000000000000000000000000
00000000000000000000000000009999999999900000000000000000000000000000000000000000
00000000000000000000000000009999999999900000000000000000000000000000000000000000
00000000000000000000000000009999999999900000000000000000000000000000000000000000
00000000000000000000000000000999999999000000000000000000000000000000000000000000
00000000000000000000000000000000000000000000000000000000000000000000000000000000
00000000000000000000000000000000000000000000000000000000000000000000000000000000
