00000000000000000000000000000000000000000000000000000000000000000000000000000000
00000000000000000000000000000000000000000000000000000000000000000000000000000000
00000000000000000000000000000000000000000000000000000000000000000000000000000000
00000000000000000000000000000000000000000000000000000000000000000000000000000000
00000000000000000000000000000000000000000000000000000000000000000000000000000000
00000000000000000000000000000000000000000000000000000000000000000000000000000000
00000000000000000000000000000000000000000000000000000088888888888880999999999000
00000000000000000000000000000000000000000000000000000888888888888889999999999900
00000000000666666666660000000000000000000000000000000888888888888889999999999900
00000000006666666666666000000000000000000000000000000888888888888889999999999900
00000000006666666666666000055555555500000000000000000888888888888888999999999900
00000000006666666666666000555555555550000000000000000988888888888888999999999900
00000000006666666666666000555555555550000000000000000888888888888888999999999900
00000000006666666666666000555555555550000000000000000888888888888889999999999900
00000000006666666666666000555555555550000000000000000888888888888889999999999900
00000000006666666666666000555555555550000000000000000888888888888889999999999900
00000000006666666666666000555555555550000000000000000888888888888889999999999000
00000000006666666666666000555555555550000000000000000888888888888889000000000000
00000000006666666666666000555555555550000000000000000888888888888889000000000000
00000000006666666666666000555555555550000000000000000888888888888889000000000000
00000000000666644466666666665533355555000000000000088888888777888880000000000000
00000000000044444444444444444333333333322222222222777777777777777770000000000000
00000000000044444444444444444333333333322222222222777777777777777770000000000000
00000000000044444444444444444333333333322222222222777777777777777770000000000000
00000000000044444444444444444333333333222222222222777777777777777770000000000000
00000000000044444444444444444333333333222222222222777777777777777770000000000000
00000000000044444444444444444333333333222222222222777777777777777770000000000000
00000000000044444444444444443333333333322222222222277777777777777770000000000000
00000000000044444444444444443333333333422222222222277777777777777770000000000000
00000000000044444444444444443333333333322222222222277777777777777770000000000000
00000000000044444444444444444335333333322222222222777777777777777770000000000000
00000000000044444444444444444000000000322222222222777777777777777770000000000000
00000000000044444444444444444000000000322222222222777777777777777770000000000000
00000000000044444444444444444000002222222221122222777777777777777770000000000000
00000000000044444444444444444000011111111111110000777777777777777770000000000000
00000000000044444444444444444000011111111111110000777777777777777770000000000000
00000000000004446444444444440000011111111111110000077777777787777700000000000000
00000000000000000000000000000000011111111111110000000000000000000000000000000000
00000000000000000000000000000000011111111111110000000000000000000000000000000000
00000000000000000000000000000000011111111111110000000000000000000000000000000000
00000000000000000000000000000000011111111111110000000000000000000000000000000000
00000000000000000000000000000000011111111111110000000000000000000000000000000000
00000000000000000000000000000000011111111111110000000000000000000000000000000000
00000000000000000000000000000000011111111111110000000000000000000000000000000000
00000000000000000000000000000000011111111111110000000000000000000000000000000000
00000000000000000000000000000000001111111111200000000000000000000000000000000000
00000000000000000000000000000000000000000000000000000000000000000000000000000000
00000000000000000000000000000000000000000000000000000000000000000000000000000000
00000000000000000000000000000000000000000000000000000000000000000000000000000000
00000000000000000000000000000000000000000000000000000000000000000000000000000000
00000000000000000000000000000000000000000000000000000000000000000000000000000000
00000000000000000000000000000000000000000000000000000000000000000000000000000000
00000000000000000000000000000000000000000000000000000000000000000000000000000000
00000000000000000000000000000000000000000000000000000000000000000000000000000000
00000000000000000000000000000000000000000000000000000000000000000000000000000000
00000000000000000000000000000000000000000000000000000000000000000000000000000000
00000000000000000000000000000000000000000000000000000000000000000000000000000000
00000000000000000000000000000000000000000000000000000000000000000000000000000000
00000000000000000000000000000000000000000000000000000000000000000000000000000000
00000000000000000000000000000000000000000000000000000000000000000000000000000000
00000000000000000000000000000000000000000000000000000000000000000000000000000000
00000000000000000000000000000000000000000000000000000000000000000000000000000000
00000000000000000000000000000000000000000000000000000000000000000000000000000000
00000000000000000000000000000000000000000000000000000000000000000000000000000000
00000000000000000000000000000000000000000000000000000000000000000000000000000000
00000000000000000000000000000000000000000000000000000000000000000000000000000000
00000000000000000000000000000000000000000000000000000000000000000000000000000000
00000000000000000000000000000000000000000000000000000000000000000000000000000000
00000000000000000000000000000000000000000000000000000000000000000000000000000000
00000000000000000000000000000000000000000000000000000000000000000000000000000000
00000000000000000000000000000000000000000000000000000000000000000000000000000000
00000000000000000000000000000000000000000000000000000000000000000000000000000000
00000000000000000000000000000000000000000000000000000000000000000000000000000000
00000000000000000000000000000000000000000000000000000000000000000000000000000000
00000000000000000000000000000000000000000000000000000000000000000000000000000000
00000000000000000000000000000000000000000000000000000000000000000000000000000000
00000000000000000000000000000000000000000000000000000000000000000000000000000000
00000000000000000000000000000000000000000000000000000000000000000000000000000000
00000000000000000000000000000000000000000000000000000000000000000000000000000000
00000000000000000000000000000000000000000000000000000000000000000000000000000000
