00000000000000000000000000000000000000000000000000000000000000000000000000000000
00000000000000000000000000000000000000000000000000000000000000000000000000000000
00000000000000000000000000000000000000000000000000000000000000000000000000000000
00000000000000000000000000000000000000000000000000000000000000000000000000000000
00000000000000000000000000000000000000000000000000000000000000000000000000000000
00000000000000000000000000000000000000000000000000000000000000000000000000000000
00000000000000000000000000000000000000000000000000000000000000000000000000000000
00000000000000000000000000000000000000000000000000000000000000000000000000000000
00000000000000000000000000000000000000000000000000000000000000000000000000000000
00000000000000000000000000000000000000000000000000000000000000000000000000000000
00000000000000000000000000000000000000000000000000000000000000000000000000000000
00000000000000000000000000000000000000000000000000000000000000000000000000000000
00000000000000000000000000000000000000000000000000000000000000000000000000000000
00000000000000000000000000000000000000000000000000000000000000000000000000000000
00000000000000000000000000000000000000000000000000000000000000000000000000000000
00000000000000000000000000000000000000000000000000000000000000000000000000000000
00000000000000000000000000000000000000000000000000000000000000000000000000000000
00000000000000000000000000000000000000000000000000000000000000000000000000000000
00000000000000000000000000000000000000000000000000000000000000000000000000000000
00000000000000000000000000000000000000000000000000000000000000000000000000000000
00000000000000000000000000000000000000000000000000000000000555555555555500000000
00000000000000000000000000000000000000000000000000000000005555555555555550000000
00000000000000000000000000000000000000000000000000000000005555555555555550000000
00000000000000000000000000000000000000000000000000000000005555555555555550000000
00000000000000000000000000000000000000000000000000000000005555555555555550000000
00000000000000000000000000000000000000000000000000000000005555555555555550000000
00000000000000000000000000000000000000000000000000000000005555555555555550000000
00000000000000000000000000000000000000000000000000000000005555555555555550000000
00000000000000000000000000000000000000000000000000000000005555555555555550000000
00000000000000000000000000000000000000000000000000000000005555555555555550000000
00000000000000000000000000000000000000000000000000000000005555555555555550000000
00000000000000000000000000000000000000000000000000000000005555555555555550000000
00000000000000000000000000000000000000000000000000000000005555555555555550000000
00000000000000000000000000000000000000000000000000000000005555555555555550000000
00000000000000000000000000000000000111111111000000000005555555554445555500000000
00000000000000000000000000000000001111111111222322222244444444444444400000000000
00000000000000000000000000000000001111111111222222222244444444444444400000000000
00000000000000000000000000000000001111111111222222222244444444444444400000000000
00000000000000000000000000000000001111111111222222222244444444444444400000000000
00000000000000000000000000000000001111111111122222222244444444444444400000000000
00000000000000000000000000000000002111111111122222222224444444444444400000000000
00000000000000000000000000000000001111111111122222222224444444444444400000000000
00000000000000000000000000000000001111111111222222222224444444444444400000000000
00000000000000000000000000000000001111111111222222222244444444444444400000000000
00000000000000000000000000000000000111111111222222222244444444444444400000000000
00000000000000000007777777777777000000000003332223393344444444444444400000000000
00000000000000000077777777777777700000000063333333333044444444444444400000000000
00000000000000000077777777777777700000000063333333333044444444444444400000000000
00000000000000000077777777777777700000000063333333333004444444444544000000000000
00000000000000000077777777777777766686666663333333333000000000000000000000000000
00000000000000000077777777777777766666666663333333333000000000000000000000000000
00000000000000000077777777777777666666666663333333333000000000000000000000000000
00000000000000000077777777777777666666666673333333333000000000000000000000000000
00000000000000000077777777777777666666666633333333333000000000000000000000000000
00000000000000000077777777777777766666666633333333336000000000000000000000000000
00000000000000000077777777777777766666666669999999339999000000000000000000000000
00000000000000000077777777777777766666666660009999999999900000000000000000000000
00000000000000000077777777777777766666666660009999999999900000000000000000000000
00000000000000000077777777777777766666666660009999999999900000000000000000000000
00000000000000000007777777777778888666888800009999999999900000000000000000000000
00000000000000000000000000000088888888888880009999999999900000000000000000000000
00000000000000000000000000000088888888888880009999999999900000000000000000000000
00000000000000000000000000000088888888888880009999999999900000000000000000000000
00000000000000000000000000000088888888888880009999999999900000000000000000000000
00000000000000000000000000000088888888888880009999999999900000000000000000000000
00000000000000000000000000000088888888888880000999999999000000000000000000000000
00000000000000000000000000000088888888888880000000000000000000000000000000000000
00000000000000000000000000000088888888888880000000000000000000000000000000000000
00000000000000000000000000000088888888888880000000000000000000000000000000000000
00000000000000000000000000000088888888888880000000000000000000000000000000000000
00000000000000000000000000000088888888888880000000000000000000000000000000000000
00000000000000000000000000000008888888888800000000000000000000000000000000000000
00000000000000000000000000000000000000000000000000000000000000000000000000000000
00000000000000000000000000000000000000000000000000000000000000000000000000000000
00000000000000000000000000000000000000000000000000000000000000000000000000000000
00000000000000000000000000000000000000000000000000000000000000000000000000000000
00000000000000000000000000000000000000000000000000000000000000000000000000000000
00000000000000000000000000000000000000000000000000000000000000000000000000000000
00000000000000000000000000000000000000000000000000000000000000000000000000000000
00000000000000000000000000000000000000000000000000000000000000000000000000000000