00000000000000000000000000000000000000000000000000000000000000000000000000000000
00000000000000000000000000000000000000000000000000000000000000000000000000000000
00000000000000000000000000000000000000000000000000000000000000000000000000000000
00000000000000000000000000000000000000000000000000000000000000000000000000000000
00000000000000000000000000000000000000000000000088888888888880000000000000000000
00000000000000000000000000000000000000000000000888888888888888000000000000000000
00000000000000000000000000000000000000000000000888888888888888000000000000000000
00000000000000000000000000000000000000000000000888888888888888000000000000000000
00000000000000000000000000000000000000000000000888888888888888000000000000000000
00000000000000000000000000000000000000000000000888888888888888777777777777777000
00000000000000000000000000000000000000000000000888888888888887777777777777777700
00000000000000000000000000000000000000000000000888888888888887777777777777777800
00000000000000000000000000000000000000000000000888888888888887777777777777777700
00000000000000000000000000000000000000000000000888888888888888777777777777777700
00000000000000000000000000000000000000000000000888888888888888777777777777777700
00000000000000000000000000000000000000000000000888888888888888777777777777777700
00000000000000000000000000000000000000000000000888888888888888777777777777777700
00000000000000000000000000000000000000000000000888888888888888777777777777777700
00000000000000000000000000000000000000000000000088888888888888777777777777777700
00000000000000000000000000000000000000000000000000000000000008777777777777777700
00000000000000000000000000000000000000000000000000000000000008777777777777777700
00000000000000000000000000000000000000000000000000000000000008777777777777777700
00000000000000000000000000000000000000000000000000000000000008777777777777777700
00000000000000000000000000000000000000000000000000000000000008777777777777777700
00000000000000000000000000000000000000000000000000000000000008777777777777777700
00000000000000000000000000000000000000000000000000000000000777777777557777777000
00000000000000000000000000000000000000000000000000000000005555555555555000000000
00000000000000000000000000000000000000000000000222222222235555555555555000000000
00000000000000000000000000000000000000000000002222222222225555555555555000000000
00000000000000000000000000000000000000000000002222222222225555555555555000000000
00000000000000000000000000000000000000000000002222222222222555555555555000000000
00000000000000000000000000000000000000000000005222222222222555555555555000000000
00000000000000000000000000000000011111111111112222222222222555555555555000000000
00000000000000000000000000000000211111111111111222222222225555555555555000000000
00000000000000000000000000000000111111111111111222222222225555555555555000000000
00000000000000000000000000000000111111111111112222222222225555555555555000000000
00000000000000000000000000000000111111111111112222222222225555555555555000000000
00000000000000000000000000000000111111111111112222222222225555555555570000000000
00000000000000000000000000000000111111111111112222222222225000000000000000000000
00000000000000000000000000000000111111111111112333333333223333433000000000000000
00000000000000000000000000000000111111111111112003333333333333333600000000000000
00000000000000000000000000000000111111111111112003333333333333333600000000000000
00000000000000000000000000000000111111111111112003333333333333333666666666666000
00000000000000000000000000000000111111111111112003333333333333333666666666666600
00000000000000000000000000000000111111111111112003333333333333333666666666666600
00000000000000000000000000000000111111111111112003333333333333333666666666666600
00000000000000000000000000000000011111111111110003333333333333333666666666666600
00000000000000000000000000000000000000000000000003333333333333333366666666666600
00000000000000000000000000000000000000000000000006333333333333333366666666666600
00000000000000000000000000000000000000000000000003333333333333333366666666666600
00000000000000000000000000000000000000000000000003333333333333333666666666666600
00000000000000000000000000000000000000000000000003333333333333333666666666666600
00000000000000000000000000000000000000000000000003333333333333333666666666666600
00000000000000000000000000000000000000000000000003333333333333333666666666666600
00000000000000000000000000000000000000000000000003333333333333333666666666666000
00000000000000000000000000000000000000000000000000444444444443339444400000000000
00000000000000000000000000000000000000000000000000000004444444444444440000000000
00000000000000000000000000000000000000000000000000000004444444444444440000000000
00000000000000000000000000000000000000000000000000000004444444444444440000000000
00000000000000000000000000000000000000000000000000000004444444444444440000000000
00000000000000000000000000000000000000000000000000000004444444444444440000000000
00000000000000000000000000000000000000000000000000000004444444444444440000000000
00000000000000000000000000000000000000000000000000000004444444444444440000000000
00000000000000000000000000000000000000000000000000000004444444444444440000000000
00000000000000000000000000000000000000000000000000000004444444444444440000000000
00000000000000000000000000000000000000000000000000000004444444444444440000000000
00000000000000000000000000000000000000000000000000000004444444444444440000000000
00000000000000000000000000000000000000000000000000000004444444444444440000000000
00000000000000000000000000000000000000000000000000000004444444444444440000000000
00000000000000000000000000000000000000000000000000000000999999944499900000000000
00000000000000000000000000000000000000000000000000000000000999999999990000000000
00000000000000000000000000000000000000000000000000000000000999999999990000000000
00000000000000000000000000000000000000000000000000000000000999999999990000000000
00000000000000000000000000000000000000000000000000000000000999999999990000000000
00000000000000000000000000000000000000000000000000000000000999999999990000000000
00000000000000000000000000000000000000000000000000000000000999999999990000000000
00000000000000000000000000000000000000000000000000000000000999999999990000000000
00000000000000000000000000000000000000000000000000000000000999999999990000000000
00000000000000000000000000000000000000000000000000000000000999999999990000000000
00000000000000000000000000000000000000000000000000000000000099999999900000000000
