00000000000000000000000000000000000000000000000000000000000000000000000000000000
00000000000000000000000000000000000000000000000000000000000000000000000000000000
00000000000000000000000000000000000000000000000000000000000000000000000000000000
00000000000000000000000000000000000000000000000000000000000000000000000000000000
00000000000000000000000000000000000000000000000000000000000000000000000000000000
00000000000000000000000000000000000000000000000000000000000000000000000000000000
00000000000000000000000000000000000000000000000000000000000000000000000000000000
00000000000000000000000000000000000000000000000000000000000000000000000000000000
00000000000000000000000000000000000000000000000000000000000000000000000000000000
00000000000000000000000000000000000000000000000000000000000000000000000000000000
00000000000000000000000000000000000000000000000000000000000000000000000000000000
00000000000000000000000000000000000000000000000000000000000000000000000000000000
00000000000000000000000000000000000000000000000000000000000000000000000000000000
00000000000000000000000000000000000000000000000000000000000000000000000000000000
00000000000000000000000000000000000000000000000000000000000000000000000000000000
00000000000000000000000000000000000000000000000000000000000000000000000000000000
00000000000000000000000000000000000000000000000000000000000000000000000000000000
00000000000000000000000000000000000000000000000000000000000000000000000000000000
00000000000000000000000000000000000000000000000000000000000000000000000000000000
00000000000000000000000000000000000000000000000000000000000000000000000000000000
00000000000000000000000000000000000000000000000000000000000000000000000000000000
00000000000000000000000000000000000000000000000000000000000000000000000000000000
00000000000000000000000000000000000000000000000000000000000000000000000000000000
00000000000000000000000000000000000000000000000000000000000000000000000000000000
00000000000000000000000000000000000000000000000000000000000000000000000000000000
00000000000000000000000000000000000000000000000000000000000000000000000000000000
00000000000000000000000000000000000000000000000000000000000000000000000000000000
00000000000000000000000000000000000000000000000000000000000000000000000000000000
00033333333333333300000000000000000000000000000000000000000000000000000000000000
00333333333333333330000000000000000000000000000000000000000000000000000000000000
00333333333333333332422222222222000000000000000000000000000000000000000000000000
00333333333333333332222222222222200000000000000000000000000000000000000000000000
00333333333333333332222222222222211111111111110000000000000000000000000000000000
00333333333333333332222222222222211111111111111000000000000000000000000000000000
00333333333333333332222222222222211111111111111000000000000000000000000000000000
00333333333333333322222222222222211111111111111000000000000000000000000000000000
00333333333333333322222222222222111111111111111000000000000000000000000000000000
00333333333333333322222222222222111111111111112000000000000000000000000000000000
00333333333333333332222222222222111111111111111000000000000000000000000000000000
00333333333333333332222222222222211111111111111000000000000000000000000000000000
00333333333333333332222222222222211111111111111000000000000000000000000000000000
00333333333333333332222222222222211111111111111000000000000000000000000000000000
00333333333333333332222222222222211111111111111000000000000000000000000000000000
00333333333333333332222222222222211111111111111000000000000000000000000000000000
00033333333334444442224444444444211111111111111000000000000000000000000000000000
00000000000064444444444444445000211111111111111000000000000000000000000000000000
00000000000064444444444444445000011111111111110000000000000000000000000000000000
00000000000064444444444444445000000000000000000000000000000000000000000000000000
00000000000064444444444444445000000000000000000000000000000000000000000000000000
00000000000064444444444444445000000000000000000000000000000000000000000000000000
06666666666664444444444444445000000000000000000000000000000000000000000000000000
66666666666664444444444444445000000000000000000000000000000000000000000000000000
66666666666664444444444444445000000000000000000000000000000000000000000000000000
66666666666664444444444444445557555555550000000000000000000000000000000000000000
66666666666664444444444444445555555555555000000000000000000000000000000000000000
66666666666644444444444444445555555555555000000000000000000000000000000000000000
66666666666644444444444444445555555555555000000000000000000000000000000000000000
66666666666644444444444444445555555555555000000000000000000000000000000000000000
66666666666664444444444444444555555555555000000000000000000000000000000000000000
66666666666664444444444444444555555555555000000000000000000000000000000000000000
66666666666664444444444444445555555555555000000000000000000000000000000000000000
66666666666660000000000000005555555555555000000000000000000000000000000000000000
06666666666600000000000000005555555555555000000000000000000000000000000000000000
00000000000000000000000000005555555555555000000000000000000000000000000000000000
00000000000000000000000000005555555555555000000000000000000000000000000000000000
00000000000000000000000000077755577777770000000000000000000000000000000000000000
00000000000000000000000000777777777770000000000000000000000000000000000000000000
00000000000000000000000000777777777770000000000000000000000000000000000000000000
00000000000000000000000000777777777770000000000000000000000000000000000000000000
00000000000000000000000000777777777770000000000000000000000000000000000000000000
00000000000000000000000000777777777770000000000000000000000000000000000000000000
00000000000000000000000000777777777770000000000000000000000000000000000000000000
00000000000000000000000000777777777770000000000000000000000000000000000000000000
00000000000000000000000000777777777770000000000000000000000000000000000000000000
00000000000000000000000000777777777770000000000000000000000000000000000000000000
00000000000000000000000000077777777700000000000000000000000000000000000000000000
00000000000000000000000000000000000000000000000000000000000000000000000000000000
00000000000000000000000000000000000000000000000000000000000000000000000000000000
00000000000000000000000000000000000000000000000000000000000000000000000000000000
00000000000000000000000000000000000000000000000000000000000000000000000000000000
