                                                                                
                                                                                
                                                                                
                                                                                
                                                                                
                                                                                
                                                                                
                                                                                
                                                                                
                                                                                
                                                                                
                                                                                
                                                                                
                                                                                
                                                                                
                                                                                
                                                                                
                                                                                
                                                                                
                                                                                
                                                                                
                                                                                
                                                                                
                                                                                
                                                                                
                                                                                
                                                                                
                                                   ---------                    
                                                  -#########-                   
                                                  -#########-                   
                                                  -#########-                   
                                                  -#########-                   
                                 -------------    -####G####-                   
                                -#############-   -#########-                   
                                -#############-   -#########-                   
                                -#############-   -#########-                   
                                -####+########-   -#########-                   
                                -++##+##++####-    ---ttt-----                  
                                -+############-   -###########-                 
                                -+#####S######-   -###########-                 
   -------------                -#############-   -###########-                 
  -#############-               -#######++####-   -###########-                 
  -#############-               -#############-   -++#########-                 
  -#############-               -#############-   -+##########-                 
  -####+########-               -##+##########-   -+##########-                 
  -++##+##++####-----------------##+##########-   -###########-                 
  -+############################-------###------  -###########-                 
  -+############################-###############- -###########-                 
  -#############################-###############- -###########-                 
  -#######++####-####+##########-###############-------###----                  
  -#############-####+##########-####+##########-#########-                     
  -#############-###############-####+##########-#########-                     
  -##+##########-###############################-#########-                     
  -##+##########-######################################+##-                     
   --------------######++#################################-                     
                -####+###+######-######++#################-                     
                -####+###+######-####+###+######-#########-                     
                -###############-####+###+######-#########-                     
                -##+####++######-###############-#########-                     
                -##+############-##+############----------                      
                -##+############-##+############-                               
                 ----------------##+############-                               
                                 ---------###---                                
                                      -#########-                               
                                      -#########-                               
                                      -#########------------                    
                                      -######+##-######+####-                   
                                      -#########-######+####-                   
                                      -#########-###########-                   
                                      -#########-###########-                   
                                      -#####################-                   
                                      -#####################-                   
                                       ----------###########-                   
                                                -###########-                   
                                                -######++###-                   
                                                -###########-                   
                                                -###########-                   
                                                 -----------                    
                                                                                
                                                                                
