                                                                                
                                                                                
                                                                                
                                                                                
                                                                                
                                                                                
                                                                                
                                                                                
                                                                                
                                                                                
                                                                                
                                                                                
                                                                                
                                                                                
                                                                                
                      ---------                                                 
                     -#########-                                                
                     -#########-                                                
                     -#########-                                                
                     -#########-                                                
                     -####G####-                                                
                     -#########-                                                
                     -#########-                                                
                     -#########-                                                
                     -#########-                                                
             ------------ttt---                                                 
            -###############-                                                   
            -###############-                                                   
            -###############-                                                   
            -###############-                                                   
            -###++##########-                                                   
            -###############-                                                   
            -#########++####-                                                   
            -###############-     -----------                                   
            -##########+####-    -##+########-                                  
            -########+#+####-    -##+########-                                  
            -####++##+++####-    -######+++##-                                  
            -###############-    -########+##-                                  
            -###########++##-    -###########-                                  
            -###############-    -#####S#####-                                  
            -###############-    -###########-                                  
             -------##---------  -##+########-                -------------     
                   -###########- -###########-               -#############-    
                   -###########- -###########-  --------------#############-    
                   -######++###- -###########- -#############-######+#+++##-    
                   -###########-------###-------#############-######+######-    
                   -###########################-######+#++###-########+####-    
                   -###########################-######+###############+####-    
                   -###########################-########+###########+++####-    
                   -###########-########################+##################-    
                   -###########-###++#################+++####-#############-    
                   -###########-#############################-#############-    
                   -###########-#########++####-#############-#############-    
                  ---###--------###############-#############-#############-    
                 -#########-   -##########+####-#############-#############-    
                 -#########-   -########+#+####-#############--------------     
                 -#########-   -####++##+++####-#############-                  
                 -#########-   -###############------###-----                   
                 -#########-   -######++###++##- -#########-                    
                 -#########-   -###############- -#########-                    
                 -#########-   -###############- -#########-                    
                 -#########-    ---------------  -#########-                    
                 -#########-                     -#########-                    
                  ---------                      -#########-                    
                                                 -#########-                    
                                                 -#########-                    
                                                 -#########-                    
                                                  ---------                     
                                                                                
                                                                                
                                                                                
                                                                                
                                                                                
                                                                                
                                                                                
                                                                                
                                                                                
                                                                                
                                                                                
                                                                                
