                                                                                
                                                                                
                                                                                
                                                                                
                                                -------------                   
                                               -#############-                  
                                               -#############-                  
                                               -#############-                  
                                               -#############-                  
                                               -########++###----------------   
                                               -########+#########+##########-  
                                               -########+#########+##########-  
                                               -##################+##########-  
                                               -#############-####+##########-  
                                               -#############-###############-  
                                               -#############-###############-  
                                               -######+######-++#############-  
                                               -######+######-###############-  
                                                --------------##+##++########-  
                                                             -##+############-  
                                                             -##++####+######-  
                                                             -########+######-  
                                                             -###############-  
                                                             -###############-  
                                                             -###############-  
                                                           ---------##-------   
                                                          -###########-         
                                               ------------###########-         
                                              -###########-###########-         
                                              -###########-###########-         
                                              -##################+++##-         
                                              -####################+##-         
                                 --------------######++############+##-         
                                -#########################-###########-         
                                -#########################-###########-         
                                -##++#########-###########-###########-         
                                -#############-###########-###########-         
                                -##########+##-###########------------          
                                -##########+##-###########-                     
                                -######S###+##----------##-------               
                                -#############-  -###############-              
                                -#############-  -###############-              
                                -#############-  -###############------------   
                                -#######++##++-  -####+##########-###########-  
                                -#############-  -###############-###########-  
                                -#############-  -###############-###########-  
                                 -------------   -++#############-###########-  
                                                 -######################+++##-  
                                                 -##+##++#################+##-  
                                                 -##+#####################+##-  
                                                 -##++####+######-###########-  
                                                 -########+######-###########-  
                                                 -###############-###########-  
                                                 -###############-###########-  
                                                 -###############------------   
                                                  -----------###-----           
                                                       -#############-          
                                                       -#############-          
                                                       -#############-          
                                                       -#############-          
                                                       -########+++++-          
                                                       -########+####-          
                                                       -########+#+##-          
                                                       -##########+##-          
                                                       -#############-          
                                                       -#############-          
                                                       -#############-          
                                                       -#############-          
                                                       -#############-          
                                                        -------ttt---           
                                                           -#########-          
                                                           -#########-          
                                                           -#########-          
                                                           -#########-          
                                                           -####G####-          
                                                           -#########-          
                                                           -#########-          
                                                           -#########-          
                                                           -#########-          
                                                            ---------           
