                                                                                
                                                                                
                                                                                
                                                                                
                                                                                
                                                                                
                                                                                
                                                                                
                                                                                
                                                                                
                                                                                
                                                                                
                                                                                
                                                                                
                                                                                
                                                                                
                                                                                
                                                                                
                                                                                
                                                                                
                                                                                
                                                              ---------         
                                                             -#########-        
                                                             -#########-        
                                                             -#########-        
                                                             -#########-        
                                                             -####G####-        
                                                             -#########-        
                                                             -#########-        
                                                             -#########-        
                                                             -#########-        
                                --------------- -----------------ttt-----       
                               -###############-###############-#########-      
                               -###############-###############-#########-      
                               -###############-###############-#########-      
                               -######+########-######+##################-      
                               -######+########-######+##################-      
                               -###############-#########################-      
                               -###++##############++##########-#########-      
                               -#######S#######################-#########-      
                               -####++##############++#########-#########-      
                               -###############-###############--------##-----  
                               -++#############-############+##-  -###########- 
                               -###############-############+##-  -###########- 
                               -###++###+++####-###+###########-  -###########- 
                               -###############-###############-  -####+######- 
                               -###############-###############-  -####+######- 
                                --------------- -------###-----   -###########- 
                                   -----------    -###########-   -##+########- 
                                  -###########-   -###########-   -##+########- 
                                  -###########-   -###########-   -##+++######- 
                                  -###########-   -####+######-   -###########- 
                                  -####+######-   -####+######-   -###########- 
                                  -####+######-   -###########-    -----------  
                                  -###########-   -##+########-                 
                                  -##+########-   -##+########-                 
                                  -##+########-   -###########-                 
                                  -###########-   -###########-                 
                                  -###########-   -###########-                 
                                  -###########-------###------                  
                                 ------###-----###############-                 
                                -#############-###############-                 
                                -#############-###############-                 
                                -#############-######+########-                 
                                -######+######-######+########-                 
                                -++++##+######-###############-                 
                                -######+##########++##########-                 
                                -#############################-                 
                                -######+###########++#########-                 
                                -######+######-###############-                 
                                -#############-############+##-                 
                                -#############-############+##-                 
                                -#############-###++###+++####-                 
                                -#############-###############-                 
                                 --------------###############-                 
                                               ---------------                  
                                                                                
                                                                                
                                                                                
                                                                                
