00000000000000000000000000000000000000000000000000000000000000000000000000000000
00000000000000000000000000000000000000000000000000000000000000000000000000000000
00000000000000000000000000000000000000000000000000000000000000000000000000000000
00000000000000000000000000000000000000000000000000000000000000000000000000000000
00000000000000000000000000000000000000000000000000000000000000000000000000000000
00000000000000000000000000000000000000000000000000000000000000000000000000000000
00000000000000000000000000000000000000000000000000000000000000000000000000000000
00000000000000000000000000000000000000000000000000000000000000000000000000000000
00000000000000000000000000000000000000000000000000000000000000000000000000000000
00000000000000000000000000000000000000000000000000000000000000000000000000000000
00000000000000000000000000000000000000000000000000000000000000000000000000000000
00000000000000000000000000000000000000000000000000000000000000000000000000000000
00000000000000000000000000000000000000000000000000000000000000000000000000000000
00000000000000000000000000000000000000000000000000000000000000000000000000000000
00000000000000000000000000000000000000000000000000000000000000000000000000000000
00000000000000000000000000000000000000000000000000000000000000000000000000000000
00000000000000000000000000000000000000000000000000000000000000000000000000000000
00000000000000000000000000000000000000000000000000000000000000000000000000000000
00000000000000000000000000000000000000000000000000000000000000000000000000000000
00000000000000000000000000000000000000000000000000000000000000000000000000000000
00000000000000000000000000000000000000000000000000000000000000000000000000000000
00000000000000000000000000000000000000000000000000000000000000999999999000000000
00000000000000000000000000000000000000000000000000000000000009999999999900000000
00000000000000000000000000000000000000000000000000000000000009999999999900000000
00000000000000000000000000000000000000000000000000000000000009999999999900000000
00000000000000000000000000000000000000000000000000000000000009999999999900000000
00000000000000000000000000000000000000000000000000000000000009999999999900000000
00000000000000000000000000000000000000000000000000000000000009999999999900000000
00000000000000000000000000000000000000000000000000000000000009999999999900000000
00000000000000000000000000000000000000000000000000000000000009999999999900000000
00000000000000000000000000000000000000000000000000000000000009999999999900000000
00000000000000000000000000000000111111111111111022222222322222999555999960000000
00000000000000000000000000000001111111111111111222222222222222255555555555000000
00000000000000000000000000000001111111111111111222222222222222255555555555000000
00000000000000000000000000000001111111111111111222222222222222255555555555000000
00000000000000000000000000000001111111111111111222222222222222225555555555000000
00000000000000000000000000000001111111111111111522222222222222225555555555000000
00000000000000000000000000000001111111111111111222222222222222225555555555000000
00000000000000000000000000000001111111111111111122222222222222255555555555000000
00000000000000000000000000000002111111111111111122222222222222255555555555000000
00000000000000000000000000000001111111111111111122222222222222255555555555000000
00000000000000000000000000000001111111111111111222222222222222256666666556666600
00000000000000000000000000000001111111111111111222222222222222250066666666666660
00000000000000000000000000000001111111111111111222222222222222250066666666666660
00000000000000000000000000000001111111111111111222222222222222250066666666666660
00000000000000000000000000000001111111111111111222222222222222250066666666666660
00000000000000000000000000000001111111111111111222222222222222250066666666666660
00000000000000000000000000000000111111111111111033333342223333300066666666666660
00000000000000000000000000000000000888888888880000333333333333300066666666666660
00000000000000000000000000000000008888888888888000333333333333300066666666666660
00000000000000000000000000000000008888888888888000333333333333300066666666666660
00000000000000000000000000000000008888888888888000333333333333300066666666666660
00000000000000000000000000000000008888888888888000333333333333300066666666666660
00000000000000000000000000000000008888888888888000333333333333300006666666666600
00000000000000000000000000000000008888888888888000333333333333300000000000000000
00000000000000000000000000000000008888888888888000333333333333300000000000000000
00000000000000000000000000000000008888888888888000333333333333300000000000000000
00000000000000000000000000000000008888888888888000333333333333300000000000000000
00000000000000000000000000000000008888888888888000333333333333300000000000000000
00000000000000000000000000000000008888888888888444444333444444000000000000000000
00000000000000000000000000000000088888877788887444444444444444400000000000000000
00000000000000000000000000000000777777777777777444444444444444400000000000000000
00000000000000000000000000000000777777777777777444444444444444400000000000000000
00000000000000000000000000000000777777777777777444444444444444400000000000000000
00000000000000000000000000000000777777777777777444444444444444400000000000000000
00000000000000000000000000000000777777777777777444444444444444400000000000000000
00000000000000000000000000000000777777777777774444444444444444400000000000000000
00000000000000000000000000000000777777777777774444444444444444700000000000000000
00000000000000000000000000000000777777777777774444444444444444400000000000000000
00000000000000000000000000000000777777777777777444444444444444400000000000000000
00000000000000000000000000000000777777777777777444444444444444400000000000000000
00000000000000000000000000000000777777777777777444444444444444400000000000000000
00000000000000000000000000000000777777777777777444444444444444400000000000000000
00000000000000000000000000000000777777777777777444444444444444400000000000000000
00000000000000000000000000000000077777778777777444444444444444400000000000000000
00000000000000000000000000000000000000000000000444444444444444000000000000000000
00000000000000000000000000000000000000000000000000000000000000000000000000000000
00000000000000000000000000000000000000000000000000000000000000000000000000000000
00000000000000000000000000000000000000000000000000000000000000000000000000000000
00000000000000000000000000000000000000000000000000000000000000000000000000000000
