00000000000000000000000000000000000000000000000000000000000000000000000000000000
00000000000000000000000000000000000000000000000000000000000000000000000000000000
00000000000000000000000000000000000000000000000000000000000000000000000000000000
00006666666660000000000000000000000000000000000000000000000000000000000000000000
00066666666666000000000000000000000000000000000000000000000000000000000000000000
00066666666666000000000000000000000000000000000000000000000000000000000000000000
00066666666666000000000000000000000000000000000000000000000000000000000000000000
00066666666666000000000000000000000000000000000000000000000000000000000000000000
00066666666666000000000000000000000000000000000000000000000000000000000000000000
00066666666666000000000000000000000000000000000000000000000000000000000000000000
00066666666666000000000000000000000000000000000000000000000000000000000000000000
00066666666666000000000000000000000000000000000000000000000000000000000000000000
00066666666666000000000000000000000000000000000000000000000000000000000000000000
00066664446666666600000000000000000000000000000000000000000000000000000000000000
00444444444444444499999999990000000000000000000000000000000000000000000000000000
00444444444444444499999999999000000000000000000000000000000000000000000000000000
00444444444444444499999999999000000000000000000000000000000000000000000000000000
00444444444444444499999999999000000000000000000000000000000000000000000000000000
00444444444444444449999999999000000000000000000000000000000000000000000000000000
00944444444444444449999999999000000000000000000000000000000000000000000000000000
00444444444444444449999999999000000000000000000000000000000000000000000000000000
00444444444444444499999999999000000000000000000000000000000000000000000000000000
00444444444444444499999999999000000000000000000000000000000000000000000000000000
00444444444444444499999999999000000000000000000000000000000000000000000000000000
00444444444444444499999999990000000000000000000000000000000000000000000000000000
00444444444444444490000000000000000000000000000000000000000000000000000000000000
00444444444444444490000000000000000000000000000000000000000000000000000000000000
00444444444444444490000000000000000000000000000000000000000000000000000000000000
00444444444444444490000000000000000000000000000000000000000000000000000000000000
00044444633344444422222227222220000000000000000000000000000000000000000000000000
00000003333333333322222222222222000000000000000000000000000000000000000000000000
00000003333333333322222222222222111111111111111000000000000000000000000000000000
00000003333333333322222222222222111111111111111100000000000000000000000000000000
00000003333333333222222222222222111111111111111100000000000000000000000000000000
00000003333333333222222222222223111111111111111100000000000000000000000000000000
00000003333333333222222222222221111111111111111100000000000000000000000000000000
00000003333333333322222222222221111111111111111200000000000000000000000000000000
00000003333333333322222222222221111111111111111100000000000000000000000000000000
00000003333333333322222222222222111111111111111100000000000000000000000000000000
00005555334555555322222222222222111111111111111100000000000000000000000000000000
00055555555555550322222222222222111111111111111100000000000000000000000000000000
00055555555555550322222222222222111111111111111100000000000000000000000000000000
00055555555555550322222222222222111111111111111100000000000000000000000000000000
00055555555555550077777722277772111111111111111100000000000000000000000000000000
00055555555555550007777777777777111111111111111100000000000000000000000000000000
00055555555555550007777777777777111111111111111100000000000000000000000000000000
00055555555555550007777777777777111111111111111100000000000000000000000000000000
00055555555555550007777777777777111111111111111000000000000000000000000000000000
00055555555555550007777777777777000000000000000000000000000000000000000000000000
00055555555555550007777777777777000000000000000000000000000000000000000000000000
00055555555555550007777777777777000000000000000000000000000000000000000000000000
00005555555555500007777777777777000000000000000000000000000000000000000000000000
00000000000000000007777777777777000000000000000000000000000000000000000000000000
00000000000000000007777777777777000000000000000000000000000000000000000000000000
00000000000000000007777777777777000000000000000000000000000000000000000000000000
00000000000000000008888877788888000000000000000000000000000000000000000000000000
00000000000000000088888888888888800000000000000000000000000000000000000000000000
00000000000000000088888888888888800000000000000000000000000000000000000000000000
00000000000000000088888888888888800000000000000000000000000000000000000000000000
00000000000000000088888888888888800000000000000000000000000000000000000000000000
00000000000000000088888888888888800000000000000000000000000000000000000000000000
00000000000000000088888888888888800000000000000000000000000000000000000000000000
00000000000000000088888888888888800000000000000000000000000000000000000000000000
00000000000000000088888888888888800000000000000000000000000000000000000000000000
00000000000000000088888888888888800000000000000000000000000000000000000000000000
00000000000000000088888888888888800000000000000000000000000000000000000000000000
00000000000000000088888888888888800000000000000000000000000000000000000000000000
00000000000000000088888888888888800000000000000000000000000000000000000000000000
00000000000000000088888888888888800000000000000000000000000000000000000000000000
00000000000000000008888888888888000000000000000000000000000000000000000000000000
00000000000000000000000000000000000000000000000000000000000000000000000000000000
00000000000000000000000000000000000000000000000000000000000000000000000000000000
00000000000000000000000000000000000000000000000000000000000000000000000000000000
00000000000000000000000000000000000000000000000000000000000000000000000000000000
00000000000000000000000000000000000000000000000000000000000000000000000000000000
00000000000000000000000000000000000000000000000000000000000000000000000000000000
00000000000000000000000000000000000000000000000000000000000000000000000000000000
00000000000000000000000000000000000000000000000000000000000000000000000000000000
00000000000000000000000000000000000000000000000000000000000000000000000000000000
00000000000000000000000000000000000000000000000000000000000000000000000000000000
