00000000000000000000000000000000000000000000000000000000000000000000000000000000
00000066666666666000000000000000000000000000000000000000000000000000000000000000
00000666666666666600000000000000000000000000000000000000000000000000000000000000
00000666666666666600000000000000000000000000000000000000000000000000000000000000
00000666666666666600000000000000000000000000000000000000000000000000000000000000
00000666666666666600000000000000000000000000000000000000000000000000000000000000
00000666666666666600000000000000000000000000000000000000000000000000000000000000
00000666666666666600000555555555555555000000000000000000000000000000000000000000
00000666666666666600005555555555555555500000000000000000000000000000000000000000
00000666666666666600005555555555555555500000000000000000000000000000000000000000
00000666666666666600005555555555555555500000000000000000000000000000000000000000
00000666666666666600005555555555555555500000000000000000000000000000000000000000
00000666666666666600005555555555555555500000000000000000000000000000000000000000
00000066664446666666665555555555555555500000000000000000000000000000000000000000
00000000444444444444444555555555555555500000000000000000000000000000000000000000
00000000544444444444444555555555555555500000000000000000000000000000000000000000
00000000444444444444444555555555555555500000000000000000000000000000000000000000
00000000444444444444445555555555555555500000000000000000000000000000000000000000
00000000444444444444445555555555555555500000000000000000000000000000000000000000
00000000444444444444445555555555555555500000000000000000000000000000000000000000
00000000444444444444445555555555555555500000000000000000000000000000000000000000
00000000444444444444445555555555555555500000000000000000000000000000000000000000
00000000444444444444445555555555555555500000000000000000000000000000000000000000
00000000444444444444445555555555555555000000000000000000000000000000000000000000
00000000444444444444445000000000000000000000000000000000000000000000000000000000
00000000444444444444445000000000000000000000000000000000000000000000000000000000
00000000444444444444445000000000000000000000000000000000000000000000000000000000
00004444444644333444440000000000000000000000000000000000000000000000000000000000
00033333333333333333000000000000000000000000000000000000000000000000000000000000
00033333333333333333000000000000000000000000000000000000000000000000000000000000
00033333333333333333222722222222200000000000000000000000000000000000000000000000
00033333333333333333222222222222220000000000000000000000000000000000000000000000
00033333333333333333222222222222220000000000000000000000000000000000000000000000
00033333333333333333222222222222221111111111100000000000000000000000000000000000
00033333333333333332222222222222221111111111110000000000000000000000000000000000
00033333333333333332222222222222231111111111110000000000000000000000000000000000
00033333333333333332222222222222211111111111110000000000000000000000000000000000
00033333333333333333222222222222211111111111120000000000000000000000000000000000
00033333333333333333222222222222211111111111110000000000000000000000000000000000
00033333333333333333222222222222221111111111110000000000000000000000000000000000
00033333333333333333222222222222221111111111110000000000000000000000000000000000
00033333333333333333222222222222221111111111110000000000000000000000000000000000
00033333333333333333222222222222221111111111110000000000000000000000000000000000
09993339999999949993222222222222221111111111110000000000000000000000000000000000
99999999999000000777772228777777721111111111110000000000000000000000000000000000
99999999999000007777777777777770001111111111100000000000000000000000000000000000
99999999999000007777777777777770000000000000000000000000000000000000000000000000
99999999999000007777777777777770000000000000000000000000000000000000000000000000
99999999999000007777777777777770000000000000000000000000000000000000000000000000
99999999999000007777777777777770000000000000000000000000000000000000000000000000
99999999999000007777777777777770000000000000000000000000000000000000000000000000
99999999999000007777777777777770000000000000000000000000000000000000000000000000
99999999999000007777777777777770000000000000000000000000000000000000000000000000
09999999990000007777777777777770000000000000000000000000000000000000000000000000
00000000000000007777777777777770000000000000000000000000000000000000000000000000
00000000000000007777777777777770000000000000000000000000000000000000000000000000
00000000000000007777777777777770000000000000000000000000000000000000000000000000
00000000000000007777777777777770000000000000000000000000000000000000000000000000
00000000000000000888888877788888000000000000000000000000000000000000000000000000
00000000000000000088888888888888800000000000000000000000000000000000000000000000
00000000000000000088888888888888800000000000000000000000000000000000000000000000
00000000000000000088888888888888800000000000000000000000000000000000000000000000
00000000000000000088888888888888800000000000000000000000000000000000000000000000
00000000000000000088888888888888800000000000000000000000000000000000000000000000
00000000000000000088888888888888800000000000000000000000000000000000000000000000
00000000000000000088888888888888800000000000000000000000000000000000000000000000
00000000000000000088888888888888800000000000000000000000000000000000000000000000
00000000000000000088888888888888800000000000000000000000000000000000000000000000
00000000000000000088888888888888800000000000000000000000000000000000000000000000
00000000000000000088888888888888800000000000000000000000000000000000000000000000
00000000000000000088888888888888800000000000000000000000000000000000000000000000
00000000000000000088888888888888800000000000000000000000000000000000000000000000
00000000000000000008888888888888000000000000000000000000000000000000000000000000
00000000000000000000000000000000000000000000000000000000000000000000000000000000
00000000000000000000000000000000000000000000000000000000000000000000000000000000
00000000000000000000000000000000000000000000000000000000000000000000000000000000
00000000000000000000000000000000000000000000000000000000000000000000000000000000
00000000000000000000000000000000000000000000000000000000000000000000000000000000
00000000000000000000000000000000000000000000000000000000000000000000000000000000
00000000000000000000000000000000000000000000000000000000000000000000000000000000
