00000000000000000000000000000000000000000000000000000000000000000000000000000000
00000000000000000000000000000000000000000000000000000000000000000000000000000000
00000000000000000000000000000000000000000000000000000000000000000000000000000000
00000000000000000000000000000000000000000000000000000000000000000000000000000000
00000000000000000000000000000000000000000000000000000000000000000000000000000000
00000000000000000000000000000000000000000000000000000000000000000000000000000000
00000000000000000000000000000000000000000000000000000000000000000000000000000000
00000000000000000000000000000000000000000000000000000000000000000000000000000000
00000000000000000000000000000000000000000000000000000000000000000000000000000000
00000000000000000000000000000000000000000000000000000000000000000000000000000000
00000000000000000000000000000000000000000000000000000000000000000000000000000000
00000000000000000000000000000000000000000000000000000000000000000000000000000000
00000000000000000000000000000000000000000000000000000000000000000000000000000000
00000000000000000000000000000000000000000000000000000000000000000000000000000000
00000000000000000000000000000000000000000000000000000000000000000000000000000000
00000000000000000000000000000000000000000000000000000000000000000000000000000000
00000000000000000000000000000000000000000000000000000000000000000000000000000000
00000000000000000000000000000000000000000000000000000000000000000000000000000000
00000000000000000000000000000000000000000000000000000000000000000000000000000000
00000000000000000000000000000000000000000000000000000000000000000000000000000000
00000000000000000000000000000000000000000000000000000000000000000000000000000000
00000000000000000000000000000000000000000000000000000000000000000000000000000000
00000000000000000000000000000000000000000000000000000000000000000000000000000000
00000000000000000000000000000000000000000000000000000000000000000000000000000000
00000000000000000000000000000000000000000000000000000000000000000000000000000000
00000000000000000000000000000000000000000000000000000000000000000000000000000000
00000000000000000000000000000000000000000000000000000000000000000000000000000000
00000000000000000000000000000000000000000000000000099999999900000000000000000000
00000000000000000000000000000000000000000000000000999999999990000000000000000000
00000000000000000000000000000000000000000000000000999999999990000000000000000000
00000000000000000000000000000000000000000000000000999999999990000000000000000000
00000000000000000000000000000000000000000000000000999999999990000000000000000000
00000000000000000000000000000000011111112111110000999999999990000000000000000000
00000000000000000000000000000000111111111111111000999999999990000000000000000000
00000000000000000000000000000000111111111111111000999999999990000000000000000000
00000000000000000000000000000000111111111111111000999999999990000000000000000000
00000000000000000000000000000000111111111111111000999999999990000000000000000000
00000000000000000000000000000000111111111111111000099966699999000000000000000000
00000000000000000000000000000000111111111111111000666666666666600000000000000000
00000000000000000000000000000000111111111111111000666666666666600000000000000000
00088888888888880000000000000000111111111111111000666666666666600000000000000000
00888888888888888000000000000000111111111111111000666666666666600000000000000000
00888888888888888000000000000000111111111111111000666666666666600000000000000000
00888888888888888000000000000000111111111111111000666666666666600000000000000000
00888888888888888000000000000000111111111111111000666666666666600000000000000000
00888888888888888777777777777777111111111111111000666666666666600000000000000000
00888888888888887777777777777777722222211124222200666666666666600000000000000000
00888888888888887777777777777777822222222222222230666666666666600000000000000000
00888888888888887777777777777777722222222222222230666666666666600000000000000000
00888888888888888777777777777777722222222222222236666663336666000000000000000000
00888888888888888777777777777777722222222222222233333333333000000000000000000000
00888888888888888777777777777777722222222222222233333333333000000000000000000000
00888888888888888777777777777777222222222222222233333333333000000000000000000000
00888888888888888777777777777777222222222222222223333333333000000000000000000000
00088888888888888777777777777777322222222222222223333333333000000000000000000000
00000000000000008777777777777777722222222222222223333333333000000000000000000000
00000000000000008777777777777777722222222222222233333333333000000000000000000000
00000000000000008777777777777777722222222222222233333333333000000000000000000000
00000000000000008777777777777777722222222222222233333333333000000000000000000000
00000000000000008777777777777777722222222222222233333333630000000000000000000000
00000000000000008777777777777777722222222222222230000000000000000000000000000000
00000000000000000777777777777777722222222222222230000000000000000000000000000000
00000000000000000000000000000000044444444422244400000000000000000000000000000000
00000000000000000000000000000000000000444444444450000000000000000000000000000000
00000000000000000000000000000000000000444444444450000000000000000000000000000000
00000000000000000000000000000000000000444444444455555555555500000000000000000000
00000000000000000000000000000000000000444444444455555555555550000000000000000000
00000000000000000000000000000000000000444444444455555555555550000000000000000000
00000000000000000000000000000000000000444444444455555555555550000000000000000000
00000000000000000000000000000000000000444444444455555555555550000000000000000000
00000000000000000000000000000000000000444444444445555555555550000000000000000000
00000000000000000000000000000000000000544444444445555555555550000000000000000000
00000000000000000000000000000000000000044444444455555555555550000000000000000000
00000000000000000000000000000000000000000000000055555555555550000000000000000000
00000000000000000000000000000000000000000000000055555555555550000000000000000000
00000000000000000000000000000000000000000000000055555555555550000000000000000000
00000000000000000000000000000000000000000000000055555555555550000000000000000000
00000000000000000000000000000000000000000000000005555555555500000000000000000000
00000000000000000000000000000000000000000000000000000000000000000000000000000000
00000000000000000000000000000000000000000000000000000000000000000000000000000000
