                                                                                
      -----------                                                               
     -###########-                                                              
     -###########-                                                              
     -########+##-                                                              
     -########+##-                                                              
     -##########+-                                                              
     -##########+-     ---------------                                          
     -#########++-    -###############-                                         
     -##+########-    -###############-                                         
     -###########-    -###############-                                         
     -###########-    -###############-                                         
     -###########-    -###+######+++##-                                         
      ----###----------##########+####-                                         
        -#######################++####-                                         
        -##########################+##-                                         
        -##################+#######+++-                                         
        -####+########-####+##########-                                         
        -####+++######-########++#####-                                         
        -######+######-###############-                                         
        -######++#####-###############-                                         
        -#############-###############-                                         
        -#############-###############-                                         
        -#############----------------                                          
        -#############-                                                         
        -#############-                                                         
        -#############-                                                         
    ----------###-----                                                          
   -###############-                                                            
   -###############-                                                            
   -###############--------------                                               
   -###############-######+######-                                              
   -##++######++###-######+######-                                              
   -##########+####-####+########------------                                   
   -#########++#########+########-###########-                                  
   -####################+++######-###########-                                  
   -####+#################+###############+##-                                  
   -####+##########-######++##############+##-                                  
   -########++#####-########################+-                                  
   -###############-#############-#####S####+-                                  
   -###############-#############-#########++-                                  
   -###############-#############-###########-                                  
   -###############-#############-##+########-                                  
 ---ttt-------------#############-###########-                                  
-#########-      -----###---------###########-                                  
-#########-     -#############-   -----------                                   
-#########-     -#############-                                                 
-#########-     -#############-                                                 
-####G####-     -####+########-                                                 
-#########-     -####+++######-                                                 
-#########-     -######+######-                                                 
-#########-     -######++#####-                                                 
-#########-     -#############-                                                 
 ---------      -#############-                                                 
                -#############-                                                 
                -#############-                                                 
                -#############-                                                 
                -#############-                                                 
                 -------###-----                                                
                  -#############-                                               
                  -#############-                                               
                  -#############-                                               
                  -####+########-                                               
                  -####+++######-                                               
                  -######+######-                                               
                  -######++#####-                                               
                  -#############-                                               
                  -#############-                                               
                  -#############-                                               
                  -######++#####-                                               
                  -#############-                                               
                  -#############-                                               
                   -------------                                                
                                                                                
                                                                                
                                                                                
                                                                                
                                                                                
                                                                                
                                                                                
