00000000000000000000000000000000000000000000000000000000000000000000000000000000
00000000000000000000000000000000000000000000000000000000000000000000000000000000
00000000000000000000000000000000000000000000000000000000000000000000000000000000
00000000000000000000000000000000000000000000000000000000000000000000000000000000
00000000000000000000000000000000000000000000000000000000000000000000000000000000
00000000000000000000000000000000000000000000000000000000000000000000000000000000
00000000000000000000000000000000000000000000000000000000000000000000000000000000
00000000000000000000000000000000000000000000000000000000000000000000000000000000
00000000000000000000000000000000000000000000000000000000000000000000000000000000
00000000000000000000000000000000000000000000000000000000000000000000000000000000
00000000000000000000000000000000000000000000000000000000000000000000000000000000
00000000000000000000000000000000000000000000000000000000000000000000000000000000
00000000000000000000000000000000000000000000000000000000000000000000000000000000
00000000000000000000000000000000000000000000000000000000000000000000000000000000
00000000000000000000000000000000000000000000000000000000000000000000000000000000
00000000000000000000009999999990000000000000000000000000000000000000000000000000
00000000000000000000099999999999000000000000000000000000000000000000000000000000
00000000000000000000099999999999000000000000000000000000000000000000000000000000
00000000000000000000099999999999000000000000000000000000000000000000000000000000
00000000000000000000099999999999000000000000000000000000000000000000000000000000
00000000000000000000099999999999000000000000000000000000000000000000000000000000
00000000000000000000099999999999000000000000000000000000000000000000000000000000
00000000000000000000099999999999000000000000000000000000000000000000000000000000
00000000000000000000099999999999000000000000000000000000000000000000000000000000
00000000000000000000099999999999000000000000000000000000000000000000000000000000
00000000000009999999999995559990000000000000000000000000000000000000000000000000
00000000000055555555555555555000000000000000000000000000000000000000000000000000
00000000000055555555555555555000000000000000000000000000000000000000000000000000
00000000000055555555555555555000000000000000000000000000000000000000000000000000
00000000000055555555555555555000000000000000000000000000000000000000000000000000
00000000000055555555555555555000000000000000000000000000000000000000000000000000
00000000000055555555555555555000000000000000000000000000000000000000000000000000
00000000000055555555555555555000000000000000000000000000000000000000000000000000
00000000000055555555555555555000001111121111100000000000000000000000000000000000
00000000000055555555555555555000011111111111110000000000000000000000000000000000
00000000000055555555555555555000011111111111110000000000000000000000000000000000
00000000000055555555555555555000011111111111110000000000000000000000000000000000
00000000000055555555555555555000011111111111110000000000000000000000000000000000
00000000000055555555555555555000011111111111110000000000000000000000000000000000
00000000000055555555555555555000011111111111110000000000000000000000000000000000
00000000000055555555555555555000011111111111110000000000000000000000000000000000
00000000000005555555335555955550011111111111110000000000000000777777777777700000
00000000000000000003333333333333011111111111110000000000000007777777777777770000
00000000000000000003333333333333011111111111110066666686666667777777777777770000
00000000000000000003333333333333011111111111110666666666666667777777777777770000
00000000000000000003333333333333222222111222222666666666666667777777777777770000
00000000000000000003333333333332222222222222222666666666666667777777777777770000
00000000000000000003333333333332222222222222222666666666666666777777777777770000
00000000000000000003333333333332222222222222222766666666666666777777777777770000
00000000000000000003333333333333222222222222222266666666666666777777777777770000
00000000000000000003333333333333222222222222222266666666666667777777777777770000
00000000000000000003333333333333222222222222222266666666666667777777777777770000
00000000000000000003333333333333222222222222222666666666666667777777777777770000
00000000000000000044433344444443222222222222222666666666666667777777777777770000
00000000000000000444444444440003222222222222222666666666666667777777777777770000
00000000000000000444444444440003222222222222222666666666666667777777777777700000
00000000000000000444444444440003222222222222222666666666666667000000000000000000
00000000000000000444444444440003222222222222222688888666888880000000000000000000
00000000000000000444444444440003222222222222222608888888888800000000000000000000
00000000000000000444444444440003222222222222222608888888888800000000000000000000
00000000000000000444444444440003222222222222222608888888888800000000000000000000
00000000000000000444444444440000222222222222222008888888888800000000000000000000
00000000000000000444444444440000000000000000000008888888888800000000000000000000
00000000000000000044444444400000000000000000000008888888888800000000000000000000
00000000000000000000000000000000000000000000000008888888888800000000000000000000
00000000000000000000000000000000000000000000000008888888888800000000000000000000
00000000000000000000000000000000000000000000000008888888888800000000000000000000
00000000000000000000000000000000000000000000000000888888888000000000000000000000
00000000000000000000000000000000000000000000000000000000000000000000000000000000
00000000000000000000000000000000000000000000000000000000000000000000000000000000
00000000000000000000000000000000000000000000000000000000000000000000000000000000
00000000000000000000000000000000000000000000000000000000000000000000000000000000
00000000000000000000000000000000000000000000000000000000000000000000000000000000
00000000000000000000000000000000000000000000000000000000000000000000000000000000
00000000000000000000000000000000000000000000000000000000000000000000000000000000
00000000000000000000000000000000000000000000000000000000000000000000000000000000
00000000000000000000000000000000000000000000000000000000000000000000000000000000
00000000000000000000000000000000000000000000000000000000000000000000000000000000
00000000000000000000000000000000000000000000000000000000000000000000000000000000
00000000000000000000000000000000000000000000000000000000000000000000000000000000
