00000000000000000000000000000000000000000000000000000000000000000000000000000000
00000000000000000000000000000000000000000000000000000000000000000000000000000000
00000000000000000000000000000000000000000000000000000000000000000000000000000000
00000000000000000000000000000000000000000000000000000000000000000000000000000000
00000000000000000000000000000000000000000000000000000000000000000000000000000000
00000000000000000000000000000000000000000000000000000000000000000000000000000000
00000000000000000000000000000000000000000000000000000000000000000000000000000000
00000000000000000000000000000000000000000000000000000000000000000000000000000000
00000000000000000000000000000000000000000000000000000000000000000000000000000000
00000000000000000000000000000000000000000000000000000000000000000000000000000000
00000000000000000000000000000000000000000000000000000000000000000000000000000000
00000000000000000000000000000000000000000000000000000000000000000000000000000000
00000000000000000000000000000000000000000000000000000000000000000000000000000000
00000000000000000000000000000000000000000000000000000000000000000000000000000000
00000000000000000000000000000000000000000000000000000000000000000000000000000000
00000000000000000000000000000000000000000000000000000000000000000000000000000000
00000000000000000000000000000000000000000000000000000000000000000000000000000000
00000000000000000000000000000000000000000000000000000000000000000000000000000000
00000000000000000000000000000000000000000000000000000000000000000000000000000000
00000000000000000000000000000000000000000000000000000000000000000000000000000000
00000000000000000000000000000000000000000000000000000000000000000000000000000000
00000000000000000000000000000000000000000000000000000000000000000000000000000000
00000000000000000000000000000000000000000000000000000000000000000000000000000000
00000000000000000000000000000000000000000000000000000000000000000000000000000000
00000000000000000000000000000000000000000000000000000000000000000000000000000000
00000000000000000000000000000000000000000000000000000000000000000000000000000000
00000000000000000000000000000000000000000000000000000000000000000000000000000000
00000000000000000000000000000000000000000000000000000000000000000000000000000000
00000000000000000000000000000000000000000000000000000000000000000000000000000000
00000000000000000000000000000000000000000000000000000000000000000000000000000000
00000000000000000000000000000000000000000000000000000000000000000000000000000000
00000000000000000000000000000000000000000000000000000000000000000000000000000000
00000000000000000000000000000000012111111111110000000000000000000000000000000000
00000000000000000000000000000000111111111111111000000000000000000000000000000000
00000000000000000000000000000000111111111111111000000000000000000000000000000000
00000000000000000000000000000000111111111111111000000000000000000000000000000000
00000000000000000000000000000000111111111111111000000000000000000000000000000000
00000000000000000000000000000000111111111111111000000000000000000000000000000000
00000000000000000000000000000000111111111111111000000000000000000000000000000000
00000000000000000000000000000000111111111111111000000000000000000000000000000000
00000000000000000000000000000000111111111111111000000000000000000000000000000000
00000000000000000000000000000000111111111111111000000000000000000000000000000000
00000000000000000000000000000000111111111111111000000000000000000000000000000000
00000000000000000000000000000000111111111111111000000000000000000000000000000000
00000000000000000000000000000000111111111111111000000000000000000000000000000000
00000000000000000000000000000000111111111111111000000000000000000000000000000000
00000000000000000000000000000222211123222222220000000000000000000000000000000000
00000000000000000000000000004222222222222000000000000000000000000000000000000000
00000000000000000000000000004222222222222000000000000000000000000000000000000000
00000000000004444444444444444222222222222000000000000000000000000000000000000000
00000000000054444444444444444222222222222000000000000000000000000000000000000000
00000000000054444444444444444222222222222000000000000000000000000000000000000000
00000000000054444444444444444222222222222000000000000000000000000000000000000000
00000000000054444444444444444222222222222000000000000000000000000000000000000000
05555575555554444444444444444222222222222000000000000000000000000000000000000000
55555555555554444444444444444222222222222000000000000000000000000000000000000000
55555555555554444444444444442222222222222000066666666666000000000000000000000000
55555555555554444444444444442222222222224000666666666666888888888800000000000000
55555555555554444444444444444333333322233333666666666666888888888890000000000000
55555555555544444444444444444033333333333333666666666666888888888890000000000000
55555555555544444444444444445033333333333333666666666666888888888890000000000000
55555555555544444444444444444033333333333333366666666666688888888899999999990000
55555555555554444444444444444063333333333333366666666666688888888899999999999000
55555555555554444444444444444033333333333333366666666666688888888899999999999000
55555555555554444444444444444033333333333333666666666666888888888899999999999000
55555555555554444444444444440033333333333333666666666666888888888889999999999000
07777555777700000000000000000033333333333333666666666666988888888889999999999000
07777777777700000000000000000033333333333333666666666666888888888899999999999000
07777777777700000000000000000033333333333333666666666666000000000099999999999000
07777777777700000000000000000033333333333333600000000000000000000099999999999000
07777777777700000000000000000033333333333333600000000000000000000099999999999000
07777777777700000000000000000033333333333333600000000000000000000009999999990000
07777777777700000000000000000003333333333333000000000000000000000000000000000000
07777777777700000000000000000000000000000000000000000000000000000000000000000000
07777777777700000000000000000000000000000000000000000000000000000000000000000000
07777777777700000000000000000000000000000000000000000000000000000000000000000000
00777777777000000000000000000000000000000000000000000000000000000000000000000000
00000000000000000000000000000000000000000000000000000000000000000000000000000000
00000000000000000000000000000000000000000000000000000000000000000000000000000000
00000000000000000000000000000000000000000000000000000000000000000000000000000000
