00000000000000000000000000000000000000000000000000000000000000000000000000000000
00000000000000000000000000000000000000000000000000000000000000000000000000000000
00000000000000000000000000000000000000000000000000000000000000000000000000000000
00000000000000000000000000000000000000000000000000000000000000000000000000000000
00000000000000000000000000000000000000000000000000000000000000000000000000000000
00000000000000000000000000000000000000000000000000000000000000000000000000000000
00000000000000000000000000000000000000000000000000000000000000000000000000000000
00000000000000000000000000000000000000000000000000000000000000000000000000000000
00000000000000000000000000000000000555555555000000000000000000000000000000000000
00000000000000000000000000000000005555555555500000000000000000000000000000000000
00000000000000000000000000000000005555555555500000000000000000000000000000000000
00000000000000000000000000000000005555555555500000000000000000000000000000000000
00000000000000000000000000000000005555555555500000000000000000000000000000000000
00000000000000000000000000000000005555555555500000000000000000000000000000000000
00000000000000000000000000000000005555555555500000000000000000000000000000000000
00000000000000000003333333330000005555555555500000000000000000000000000000000000
00000000000000000033333333333000005555555555500000000000000000000000000000000000
00000000000000000033333333333000005555555555500000000000000000000000000000000000
00000000000000000033333333333555555555222555000000000000000000000000000000000000
00000000000000000033333333332222222222222222400000000000000000000000000000000000
00000000000000000033333333332222222222222222300000000000000000000000000000000000
00000000000000000033333333332222222222222222444444444444444400000000000000000000
00000000000000000033333333333222222222222222444444444444444440000000000000000000
00000000000000000033333333333222222222222222444444444444444440000000000000000000
00000000000000000033333333333222222222222222444444444444444440000000000000000000
00000000000000000003333333333222222222222222444444444444444440000000000000000000
00000000000000000000000000003222222222222222444444444444444440000000000000000000
00000000000000000000000000003222222222222222444444444444444440000000000000000000
00000000000000000000000000003222222222222222244444444444444440000000000000000000
00000000000000000000000000003222222222222222244444444444444440000000000000000000
00000000000000000000000000003222222222222222244444444444444440000000000000000000
00000000000000000000000000003222222222222222444444444444444440000000000000000000
00000000000000000000000000003222222222222222444444444444444440000000000000000000
00000000000000000000000000003222222222222222444444444444444440000000000000000000
00000000000000000000000000000222222111252222444444444444444440000000000000000000
00000000000000000000000000000000001111111111444444444444444440000000000000000000
00000000000000000000000000000000001111111111444444444444444440000000000000000000
00000000000000000000000000000000001111111111144444444444444400000000000000000000
00000000000000000000000000000000001111111111100000000000000000000000000000000000
00000000000000000000000000000000001111111111100000000000000000000000000000000000
00000000000000000000000000000000001111111111100000000000000000000000000000000000
00000000000000000000000000000000001111111111100000000000000000000000000000000000
00000000000000000000000000000000001111111111100000000000000000000000000000000000
00000000000000000000000000000000001111111111100000000000000000000000000000000000
00000000000000000000000000000000000121111111000000000000000000000000000000000000
00000000000000000000000000000000000000000000000000000000000000000000000000000000
00000000000000000000000000000000000000000000000000000000000000000000000000000000
00000000000000000000000000000000000000000000000000000000000000000000000000000000
00000000000000000000000000000000000000000000000000000000000000000000000000000000
00000000000000000000000000000000000000000000000000000000000000000000000000000000
00000000000000000000000000000000000000000000000000000000000000000000000000000000
00000000000000000000000000000000000000000000000000000000000000000000000000000000
00000000000000000000000000000000000000000000000000000000000000000000000000000000
00000000000000000000000000000000000000000000000000000000000000000000000000000000
00000000000000000000000000000000000000000000000000000000000000000000000000000000
00000000000000000000000000000000000000000000000000000000000000000000000000000000
00000000000000000000000000000000000000000000000000000000000000000000000000000000
00000000000000000000000000000000000000000000000000000000000000000000000000000000
00000000000000000000000000000000000000000000000000000000000000000000000000000000
00000000000000000000000000000000000000000000000000000000000000000000000000000000
00000000000000000000000000000000000000000000000000000000000000000000000000000000
00000000000000000000000000000000000000000000000000000000000000000000000000000000
00000000000000000000000000000000000000000000000000000000000000000000000000000000
00000000000000000000000000000000000000000000000000000000000000000000000000000000
00000000000000000000000000000000000000000000000000000000000000000000000000000000
00000000000000000000000000000000000000000000000000000000000000000000000000000000
00000000000000000000000000000000000000000000000000000000000000000000000000000000
00000000000000000000000000000000000000000000000000000000000000000000000000000000
00000000000000000000000000000000000000000000000000000000000000000000000000000000
00000000000000000000000000000000000000000000000000000000000000000000000000000000
00000000000000000000000000000000000000000000000000000000000000000000000000000000
00000000000000000000000000000000000000000000000000000000000000000000000000000000
00000000000000000000000000000000000000000000000000000000000000000000000000000000
00000000000000000000000000000000000000000000000000000000000000000000000000000000
00000000000000000000000000000000000000000000000000000000000000000000000000000000
00000000000000000000000000000000000000000000000000000000000000000000000000000000
00000000000000000000000000000000000000000000000000000000000000000000000000000000
00000000000000000000000000000000000000000000000000000000000000000000000000000000
00000000000000000000000000000000000000000000000000000000000000000000000000000000
00000000000000000000000000000000000000000000000000000000000000000000000000000000
