00000000000000000000000000000000000000000000000000000000000000000000000000000000
00000000000000000000000000000000000000000000000000000000000000000000000000000000
00000000000000000000000000000000000000000000000000000000000000000000000000000000
00000000000000000000000000000000000000000000000000000000000000000000000000000000
00000000000000000000000000000000000000000000000000000000000000000000000000000000
00000000000000000000000000000000000000000000000000000000000000000000000000000000
00000000000000000000000000000000000000000000000000000000000000000000000000000000
00000000000000000000000000000000000000000000000000000000000000000000000000000000
00000000000000000000000555555555000000000000000000000000000000000000000000000000
00000000000000000000005555555555500000000000000000000000000000000000000000000000
00000000000000000000005555555555500000000000000000000000000000000000000000000000
00000000000000000000005555555555500000000000000000000000000000000000000000000000
00000000000004444444445555555555500000000000000000000000000000000000000000000000
00000000000054444444444555555555500000000000000000000000000000000000000000000000
00000000000044444444444555555555500000000000000000000000000000000000000000000000
00000000000044444444445555555555500000000000000000000000000000000000000000000000
00000000000044444444445555555555500000000000000000000000000000000000000000000000
00000000000044444444445555555555500000000000000000000000000000000000000000000000
00000000000044444444445555555555000000000000000000000000000000000000000000000000
00000000000044444444445000000000000000000000000000000000000000000000000000000000
00000000000044444444445000000000000000000000000000000000000000000000000000000000
00000000000044444444445000002222222220000000000000000000000000000000000000000000
00000000000044443334444444432222222222000000000000000000000000000000000000000000
00000000000333333333333333332222222222000000000000000000000000000000000000000000
00000000000333333333333333332222222222000000000000000000000000000000000000000000
00000000000333333333333333332222222222000000000000000000000000000000000000000000
00000000000333333333333333332222222222000000000000000000000000000000000000000000
00000000000333333333333333332222222222000000000000000000000000000000000000000000
00000000000333333333333333332222222222000000000000000000000000000000000000000000
00000000000333333333333333322222222222000000000000000000000000000000000000000000
00000000000333333333333333322222222223000000000000000000000000000000000000000000
00000000000333333333333333332222112222222222222000000000000000000000000000000000
00000000000333333333333333330001111111111111111100000000000000000000000000000000
00000000000333333333333333330001111111111111111100000000000000000000000000000000
00000000000333333333333333330001111111111111111100000000000000000000000000000000
00000000000333333333333333330001111111111111111100000000000000000000000000000000
00000000000333333333333333330001111111111111111100000000000000000000000000000000
00000000000333333333333333330001111111111111111100000000000000000000000000000000
00000000000033333433333333300001111111111111111100000000000000000000000000000000
00000000000000000000000000000001111111111111111100000000000000000000000000000000
00000000000000000000000000000001111111111111111100000000000000000000000000000000
00000000000000000000000000000001111111111111111100000000000000000000000000000000
00000000000000000000000000000001111111111111111100000000000000000000000000000000
00000000000000000000000000000001111111111111111100000000000000000000000000000000
00000000000000000000000000000001111111111111111100000000000000000000000000000000
00000000000000000000000000000001111111111111111100000000000000000000000000000000
00000000000000000000000000000001111111111111111100000000000000000000000000000000
00000000000000000000000000000000211111111111111000000000000000000000000000000000
00000000000000000000000000000000000000000000000000000000000000000000000000000000
00000000000000000000000000000000000000000000000000000000000000000000000000000000
00000000000000000000000000000000000000000000000000000000000000000000000000000000
00000000000000000000000000000000000000000000000000000000000000000000000000000000
00000000000000000000000000000000000000000000000000000000000000000000000000000000
00000000000000000000000000000000000000000000000000000000000000000000000000000000
00000000000000000000000000000000000000000000000000000000000000000000000000000000
00000000000000000000000000000000000000000000000000000000000000000000000000000000
00000000000000000000000000000000000000000000000000000000000000000000000000000000
00000000000000000000000000000000000000000000000000000000000000000000000000000000
00000000000000000000000000000000000000000000000000000000000000000000000000000000
00000000000000000000000000000000000000000000000000000000000000000000000000000000
00000000000000000000000000000000000000000000000000000000000000000000000000000000
00000000000000000000000000000000000000000000000000000000000000000000000000000000
00000000000000000000000000000000000000000000000000000000000000000000000000000000
00000000000000000000000000000000000000000000000000000000000000000000000000000000
00000000000000000000000000000000000000000000000000000000000000000000000000000000
00000000000000000000000000000000000000000000000000000000000000000000000000000000
00000000000000000000000000000000000000000000000000000000000000000000000000000000
00000000000000000000000000000000000000000000000000000000000000000000000000000000
00000000000000000000000000000000000000000000000000000000000000000000000000000000
00000000000000000000000000000000000000000000000000000000000000000000000000000000
00000000000000000000000000000000000000000000000000000000000000000000000000000000
00000000000000000000000000000000000000000000000000000000000000000000000000000000
00000000000000000000000000000000000000000000000000000000000000000000000000000000
00000000000000000000000000000000000000000000000000000000000000000000000000000000
00000000000000000000000000000000000000000000000000000000000000000000000000000000
00000000000000000000000000000000000000000000000000000000000000000000000000000000
00000000000000000000000000000000000000000000000000000000000000000000000000000000
00000000000000000000000000000000000000000000000000000000000000000000000000000000
00000000000000000000000000000000000000000000000000000000000000000000000000000000
00000000000000000000000000000000000000000000000000000000000000000000000000000000
