00000000000000000000000000000000000000000000000000000000000000000000000000000000
00000000000000000000000000000000000000000000000000000000000000000000000000000000
00000000000000000000000000000000000000000000000000000000000000000000000000000000
00000000000000000000000000000000000000000000000000000000000000000000000000000000
00000000000000000000000000000000000000000000000000000000000000000000000000000000
00000000000000000000000000000000000000000000000000000000000000000000000000000000
00000000000000000000000000000000000000000000000000000000000000000000000000000000
00000000000000000000066666666666660000000000000000000000000000000000000000000000
00000000000777777777766666666666666000000000000000000000000000000000000000000000
00000000007777777777766666666666666000000000000000000000000000000000000000000000
00000000007777777777766666666666666000000000000000000000000000000000000000000000
00000000007777777777766666666666666000000000000000000000000000000000000000000000
00000000007777777777666666666666666000000000000000000000000000000000000000000000
00000000007777777777666666666666667000000000000000000000000000000000000000000000
00000000007777777777666666666666666000000000000000000000000000000000000000000000
00000000007777777777766666666666666000000000000000000000000000000000000000000000
00000000007777777777766666666666666000000000000000000000000000000000000000000000
00000000007777777777766666666666666000000000000000000000000000000000000000000000
00000000000777777777766666666666666000000000000000000000000000000000000000000000
00000000000000000000766666666666666000000000000000000000000000000000000000000000
00000000000000000000766666666666666000000000000000000000000000000000000000000000
00000000000000000000066666333666666022222222200000000000000000000000000000000000
00000000004444444445444444333333333322222222220000000000000000000000000000000000
00000000044444444444444444333333333322222222220000000000000000000000000000000000
00000000044444444444444444333333333322222222220000000000000000000000000000000000
00000000044444444444444444333333333222222222220000000000000000000000000000000000
00000000044444444444444444333333333222222222230000000000000000000000000000000000
00000000044444444444444444333333333222222222220000000000000000000000000000000000
00000000044444444444444444333333333322222222220000000000000000000000000000000000
00000000044444444444444443333333333322222222220000000000000000000000000000000000
00000000044444444444444443333333333422222222220000000000000000000000000000000000
00000000044444444444444444363333333222211122222000000000000000000000000000000000
00000000044444444444444444000001111111111111111100000000000000000000000000000000
00000000044444444444444444000001111111111111111100000000000000000000000000000000
00000000044444444444444444000001111111111111111100000000000000000000000000000000
00000000044444444444444444000001111111111111111100000000000000000000000000000000
00000000044444444444444444000001111111111111111100000000000000000000000000000000
00000000044444444444444444000001111111111111111100000000000000000000000000000000
00000000005555555544485550000001111111111111111100000000000000000000000000000000
00000000000000555555555550000001111111111111111100000000000000000000000000000000
00000000000000555555555550000001111111111111111100000000000000000000000000000000
00000000000000555555555550000001111111111111111100000000000000000000000000000000
00000000000000555555555550000001111111111111111100000000000000000000000000000000
00000000000000555555555550000001111111111111111100000000000000000000000000000000
00000000000000555555555550000001111111111111111100000000000000000000000000000000
00000000000000555555555550000001111111111111111100000000000000000000000000000000
00000000000000555555555550000001111111111111111100000000000000000000000000000000
00000000000000555555555550000000111111112111111000000000000000000000000000000000
00000000000000088888555988880000000000000000000000000000000000000000000000000000
00000000000000888888888888888000000000000000000000000000000000000000000000000000
00000000000000888888888888888000000000000000000000000000000000000000000000000000
00000000000000888888888888888000000000000000000000000000000000000000000000000000
00000000000000888888888888888000000000000000000000000000000000000000000000000000
00000000000000888888888888888000000000000000000000000000000000000000000000000000
00000000000000888888888888888000000000000000000000000000000000000000000000000000
00000000000000888888888888888000000000000000000000000000000000000000000000000000
00000000000000888888888888888000000000000000000000000000000000000000000000000000
00000000000000888888888888888000000000000000000000000000000000000000000000000000
00000000000000888888888888888000000000000000000000000000000000000000000000000000
00000000000000888888888888888000000000000000000000000000000000000000000000000000
00000000000000888888888888888000000000000000000000000000000000000000000000000000
00000000000000888888888888888000000000000000000000000000000000000000000000000000
00000000000000099999998889990000000000000000000000000000000000000000000000000000
00000000000000000099999999999000000000000000000000000000000000000000000000000000
00000000000000000099999999999000000000000000000000000000000000000000000000000000
00000000000000000099999999999000000000000000000000000000000000000000000000000000
00000000000000000099999999999000000000000000000000000000000000000000000000000000
00000000000000000099999999999000000000000000000000000000000000000000000000000000
00000000000000000099999999999000000000000000000000000000000000000000000000000000
00000000000000000099999999999000000000000000000000000000000000000000000000000000
00000000000000000099999999999000000000000000000000000000000000000000000000000000
00000000000000000099999999999000000000000000000000000000000000000000000000000000
00000000000000000009999999990000000000000000000000000000000000000000000000000000
00000000000000000000000000000000000000000000000000000000000000000000000000000000
00000000000000000000000000000000000000000000000000000000000000000000000000000000
00000000000000000000000000000000000000000000000000000000000000000000000000000000
00000000000000000000000000000000000000000000000000000000000000000000000000000000
00000000000000000000000000000000000000000000000000000000000000000000000000000000
00000000000000000000000000000000000000000000000000000000000000000000000000000000
00000000000000000000000000000000000000000000000000000000000000000000000000000000
