00000000000000000000000000000000000000000000000000000000000000000000000000000000
00099999999900000000000000000000000000000000000000000000000000000000000000000000
00999999999990000000000000000000000000000088888888888880000000000000000000000000
00999999999990000000000000000000000000000888888888888888000000000000000000000000
00999999999990000000000000000066666666666888888888888888000000000000000000000000
00999999999990000000000000000666666666666888888888888888000000000000000000000000
00999999999990000000000000000666666666666888888888888888000000000000000000000000
00999999999990000000000000000666666666666888888888888888000000000000000000000000
00999999999990000000000000000666666666666688888888888888000000000000000000000000
00999999999990005555555555555866666666666688888888888888000000000000000000000000
00999999999990065555555555555566666666666688888888888888000000000000000000000000
00099977799999975555555555555566666666666888888888888888000000000000000000000000
00077777777777775555555555555666666666666888888888888888000000000000000000000000
00077777777777775555555555555666666666666888888888888888000000000000000000000000
00077777777777775555555555555666666666666888888888888888000000000000000000000000
00077777777777775555555555555666666666666888888888888888000000000000000000000000
00077777777777755555555555555666666666666088888888888880000000000000000000000000
00077777777777755555555555555600000000000000000000000000000000000000000000000000
00077777777777755555555555555600000000000000000000000000000000000000000000000000
00077777777777775555555555555600000000000000000000000000000000000000000000000000
00077777777777775555555555555622222222222000000000000000000000000000000000000000
00077777777777775555555555555622222222222200000000000000000000000000000000000000
00077777777777775555555555555622222222222200000000000000000000000000000000000000
00007779777777705555533355555322222222222200000000000000000000000000000000000000
00000000000000043333333333333322222222222200000000000000000000000000000000000000
00000000000000043333333333333322222222222200000000000000000000000000000000000000
00000000000000043333333333333322222222222200000000000000000000000000000000000000
00444444444444443333333333333322222222222200000000000000000000000000000000000000
04444444444444443333333333333322222222222200000000000000000000000000000000000000
04444444444444443333333333333222222222222200000000000000000000000000000000000000
04444444444444443333333333333222222222222300000000000000000000000000000000000000
04444444444444443333333333333222222222222200000000000000000000000000000000000000
04444444444444443333333333333322221112222222220000000000000000000000000000000000
04444444444444433333333333333300111111111111111000000000000000000000000000000000
04444444444444433333333333333400111111111111111000000000000000000000000000000000
04444444444444433333333333333300111111111111111000000000000000000000000000000000
04444444444444443333333333333300111111111111111000000000000000000000000000000000
04444444444444443333335333333000111111111111111000000000000000000000000000000000
04444444444444440000000000000000111111111111111000000000000000000000000000000000
04444444444444440000000000000000111111111111111000000000000000000000000000000000
04444444444444440000000000000000111111111111111000000000000000000000000000000000
00444444444444400000000000000000111111111111111000000000000000000000000000000000
00000000000000000000000000000000111111111111111000000000000000000000000000000000
00000000000000000000000000000000111111111111111000000000000000000000000000000000
00000000000000000000000000000000111111111111111000000000000000000000000000000000
00000000000000000000000000000000111111111111111000000000000000000000000000000000
00000000000000000000000000000000011211111111110000000000000000000000000000000000
00000000000000000000000000000000000000000000000000000000000000000000000000000000
00000000000000000000000000000000000000000000000000000000000000000000000000000000
00000000000000000000000000000000000000000000000000000000000000000000000000000000
00000000000000000000000000000000000000000000000000000000000000000000000000000000
00000000000000000000000000000000000000000000000000000000000000000000000000000000
00000000000000000000000000000000000000000000000000000000000000000000000000000000
00000000000000000000000000000000000000000000000000000000000000000000000000000000
00000000000000000000000000000000000000000000000000000000000000000000000000000000
00000000000000000000000000000000000000000000000000000000000000000000000000000000
00000000000000000000000000000000000000000000000000000000000000000000000000000000
00000000000000000000000000000000000000000000000000000000000000000000000000000000
00000000000000000000000000000000000000000000000000000000000000000000000000000000
00000000000000000000000000000000000000000000000000000000000000000000000000000000
00000000000000000000000000000000000000000000000000000000000000000000000000000000
00000000000000000000000000000000000000000000000000000000000000000000000000000000
00000000000000000000000000000000000000000000000000000000000000000000000000000000
00000000000000000000000000000000000000000000000000000000000000000000000000000000
00000000000000000000000000000000000000000000000000000000000000000000000000000000
00000000000000000000000000000000000000000000000000000000000000000000000000000000
00000000000000000000000000000000000000000000000000000000000000000000000000000000
00000000000000000000000000000000000000000000000000000000000000000000000000000000
00000000000000000000000000000000000000000000000000000000000000000000000000000000
00000000000000000000000000000000000000000000000000000000000000000000000000000000
00000000000000000000000000000000000000000000000000000000000000000000000000000000
00000000000000000000000000000000000000000000000000000000000000000000000000000000
00000000000000000000000000000000000000000000000000000000000000000000000000000000
00000000000000000000000000000000000000000000000000000000000000000000000000000000
00000000000000000000000000000000000000000000000000000000000000000000000000000000
00000000000000000000000000000000000000000000000000000000000000000000000000000000
00000000000000000000000000000000000000000000000000000000000000000000000000000000
00000000000000000000000000000000000000000000000000000000000000000000000000000000
00000000000000000000000000000000000000000000000000000000000000000000000000000000
00000000000000000000000000000000000000000000000000000000000000000000000000000000
