                                                                                
                                                                                
                                                                                
                                                                                
                                                                                
                                                                                
                                                                                
                                                                                
                                                                                
                                                                                
                                                                                
                                                                                
                                                                                
                                                                                
                                                                                
                                                                                
                                                                                
                                                                                
                                                                                
                                                                                
                                                           -------------        
                                                          -##+##########-       
                                                          -##+##########-       
                                                          -####++#######-       
                                                          -#############-       
                                                          -######+######-       
                                                          -######+######-       
                                                          -#############-       
                                                          -#############-       
                                                          -######++#####-       
                                                          -########+####-       
                                                          -#############-       
                                                          -#############-       
                                                          -#############-       
                                   ---------           ---------###-----        
                                  -#########-----------##+##########-           
                                  -#########-#########-##+##########-           
                                  -#########-#########-####++#######-           
                                  -#########-####+####-#############-           
                                  -####S#########+####-######+######-           
                                  -##+###########+###########+######-           
                                  -##+##############################-           
                                  -##+######-#######################-           
                                  -##+######-#########-######++#####-           
                                   ----------#########-########+####-           
                   -------------           ---###------########+++##-           
                  -##+##########-         -#########- -#############-           
                  -##+##########-         -#########- -#############-           
                  -####++#######-         -#########-  -------------            
                  -#############-----------####+####-                           
                  -######+######-#########-####+####-                           
                  -######+################-#########-                           
                  -##################+####-#########-                           
                  -##################+##############-                           
                  -######++#####-####+##############-                           
                  -########+####-#########--------tt----                        
                  -########++###-#########-   -#########-                       
                  -#############-#########-   -#########-                       
                  -#############-#########-   -#########-                       
                   ----------------###----    -#########-                       
                              -###########-   -####G####-                       
                              -###########-   -#########-                       
                              -###########-   -#########-                       
                              -###########-   -#########-                       
                              -###########-   -#########-                       
                              -###########-    ---------                        
                              -###########-                                     
                              -###########-                                     
                              -###++####++-                                     
                              -######+####-                                     
                              -####+++####-                                     
                               -----------                                      
                                                                                
                                                                                
                                                                                
                                                                                
                                                                                
                                                                                
                                                                                
                                                                                
