00000000000000000000000000000000000000000000000000000000000000000000000000000000
00000000000000000000000000000000000000000000000000000000000000000000000000000000
00000000000000000000000000000000000000000000000000000000000000000000000000000000
00000000000000000000000000000000000000000000000000000000000000000000000000000000
00000000000000000000000000000000000000000000000000000000000000000000000000000000
00000000000000000000000000000000000000000000000000000000000000000000000000000000
00000000000000000000000000000000000000000000000000000000000000000000000000000000
00000000000000000000000000000000000000000000000000000000000000000000000000000000
00000000000000000000000000000000000000000000000000000000000000000000000000000000
00000000000000000000000000000000000000000000000000000000000000000000000000000000
00000000000000000000000000000000000000000000000000000000000000000000000000000000
00000000000000000000000000000000000000000000000000000000000000000000000000000000
00000000000000000000000000000000000000000000000000000000000000000000000000000000
00000000000000000000000000000000000000000000000000000000000000000000000000000000
00000000000000000000000000000000000000000000000000000000000000000000000000000000
00000000000000000000000000000000000000000000000000000000000000000000000000000000
00000000000000000000000000000000000000000000000000000000000000000000000000000000
00000000000000000000000000000000000000000000000000000000000000000000000000000000
00000000000000000000000000000000000000000000000000000000000000000000000000000000
00000000000000000000000000000000000000000000000000000000000000000000000000000000
00000000000000000000000000000000000000000000000000000000000000000000000000000000
00000000000000000000000000000000000000000000000000000000000000000000000000000000
00000000000000000000000000000000000000000000000000000000000000000000000000000000
00000000000000000000000000000000000000000000000000000000000000000000000000000000
00000000000000000000000000000000000000000000000000000000000000000000000000000000
00000000000000000000000000000000000000000000000000000000000000000000000000000000
00000000000000000000000000000000000000000000000000000000000000000000000000000000
00000000000000000000000000000000000000000000000000000000000000000000000000000000
00000000000000000000000000000000000000000000000000000000000000000000000000000000
00000000000000000000000000000000000000000000000000000000000000000000000000000000
00000000000000000000000000000000000000000000000000000000000000000000000000000000
00000000000000000000000000000000000000000000000000000000000000000000000000000000
00000000000000000000000000000000000000000000000000000000000000000000000000000000
00000000000000000000000000000000001112111111100000000000000000000000000000000000
00000000000000000000000000000000011111111111110000000000000000000000000000000000
00000000000000000000000000000000011111111111110000000000000000000000000000000000
00000000000000000000000000000000011111111111110000000000000000000000000000000000
00000000000000000000000000000000011111111111110000000000000000000000000000000000
00000000000000000000000000000000011111111111110000000000000000000000000000000000
00000000000000000000000000000000011111111111110000000000000000000000000000000000
00000000000000000000000000000000011111111111110000000000000000000000000000000000
00000000000000000000000000000000011111111111110000000000000000000000000000000000
00000000000000000000000000000000011111111111110000000000000000000000000000000000
00000000000000000000000000000000011111111111110000000000000000000000000000000000
00000000000000000000033333333333011111111111110000000000000000000000000000000000
00000000000000000000333333333333322211122222200000000000000000000000000000000000
00000000000000000000333333333333322222222220000000000000000000000000000000000000
00000000000000000000333333333333322222222220000000000000000000000000000000000000
00000000000000000000333333333333322222222220000000000000000000000000000000000000
00000000000000000000333333333333222222222220000000000000000000000000000000000000
00000000000000000000333333333333222222222230000000000000000000000000000000000000
00000000000000000000333333333333222222222220000000000000000000000000000000000000
00000000000000000000333333333333322222222220000000000000000000000000000000000000
00000000000000000000333333333333322222222220000000000000000000000000000000000000
00000000000000000000333333333333322222222220000000000000000000000000000000000000
00000000000000000000333333333333344442224440000000000000000000000000000000000000
00000000000000000000033333333333044444444444000000000000000000000000000000000000
00000000000000000000000000000000044444444444000000000000000000000000000000000000
00000000000000000000000000000000044444444444000000000000000000000000000000000000
00000000000000000000000000000000044444444444000000000000000000000000000000000000
00000000000000000000000000000000044444444444000000000000000000000000000000000000
00000000000000000000000000000000044444444444000000000000000000000000000000000000
00000000000000000000000000000000044444444444000000000000000000000000000000000000
00000000000000000000000000000000044444444444000000000000000000000000000000000000
00000000000000000000000000000000044444444444000000000000000000000000000000000000
00000000000000000000000000000000005554445550000000000000000000000000000000000000
00000000000000000000000000000000055555555555000000000000000000000000000000000000
00000000000000000000000000000000055555555555000000000000000000000000000000000000
00000000000000000000000000000000055555555555000000000000000000000000000000000000
00000000000000000000000000000000055555555555000000000000000000000000000000000000
00000000000000000000000000000000055555555555000000000000000000000000000000000000
00000000000000000000000000000000055555555555000000000000000000000000000000000000
00000000000000000000000000000000055555555555000000000000000000000000000000000000
00000000000000000000000000000000055555555555000000000000000000000000000000000000
00000000000000000000000000000000055555555555000000000000000000000000000000000000
00000000000000000000000000000000005555555550000000000000000000000000000000000000
00000000000000000000000000000000000000000000000000000000000000000000000000000000
00000000000000000000000000000000000000000000000000000000000000000000000000000000
00000000000000000000000000000000000000000000000000000000000000000000000000000000
00000000000000000000000000000000000000000000000000000000000000000000000000000000
