00000000000000000000000000000000000000000000000000000000000000000000000000000000
00000000000000000000000000000000000000000000000000000000000000000000000000000000
00000000000000000000000000000000000000000000000000000000000000000000000000000000
00000000000000000000000000000000000000000000000008888888888888880999999999000000
00000000000000000000000000000000000000000000000088888888888888889999999999900000
00000000000000000000000000000000000000000000000088888888888888889999999999900000
00000000000000000000000000000000000000000000000088888888888888889999999999900000
00000000000000000000000000000000000000000000000088888888888888888999999999900000
00000000000000000000000000000000000000000000000098888888888888888999999999900000
00000000000000000000000000000000000000000000000088888888888888888999999999900000
00000000000000000000000000000000000000000000000088888888888888889999999999900000
00000000000000000000000000000000000000000000000088888888888888889999999999900000
00000000000000000000000000000000000000000000000088888888888888889999999999900000
00000000000000000000000000000000000000000000000088888888888888889999999999000000
00000000000000000000000000000000000000000000000088888888888888889000000000000000
00000000000000000000000000000000000000000000000088888888888888889000000000000000
00000000000000000000000000000000000000000000000088888888888888889000000000000000
00000000000000000000000000000000000000000000000088888888888888889000000000000000
00000000000000000000000000000000000000000000000088888888888888889000000000000000
00000000000000000000000000000000000000000000000008888887778888880000000000000000
00000000000000000000000000000000000000000000000000077777777777000000000000000000
00000000000000000000000000000000000000000000000000077777777777000000000000000000
00000000000000000000000000000000000000000000000000077777777777666666666660000000
00000000000000000000000000000000000000000000000000077777777776666666666666000000
00000000000000000000000000000000000000000000000000077777777776666666666667000000
00000000000000000000000000000000000000000000000000077777777776666666666666000000
00000000000000000000000000000000000000000000000000077777777777666666666666000000
00000000000000000000000000000000000000000000000000077777777777666666666666000000
00000000000000000000000000000000000000000000000000077777777777666666666666000000
00000000000000000000000000000000000000000000000000007777877777666666666666000000
00000000000000000000000000000000000000000000002422222222222227666666666666000000
00000000000000000000000000000000000000000000022222222222222227666666666666000000
00000000000000000000000000000000000000000000022222222222222227666666666666000000
00000000000000000000000000000000001111111111122222222222222227666666666666000000
00000000000000000000000000000000011111111111122222222222222223666633366660000000
00000000000000000000000000000000011111111111122222222222222223333333333300000000
00000000000000000000000000000000011111111111122222222222222223333333333300000000
00000000000000000000000000000000011111111111112222222222222223333333333300000000
00000000000000000000000000000000021111111111112222222222222222333333333300000000
00000000000000000000000000000000011111111111112222222222222222333333333300000000
00000000000000000000000000000000011111111111122222222222222222333333333300000000
00000000000000000000000000000000011111111111122222222222222223333333333300000000
00000000000000000000000000000000011111111111122222222222222223333333333300000000
00000000000000000000000000000000011111111111122222222222222223333333333300000000
00000000000000000000000000000000011111111111122222222222222223555555533555555000
00000000000000000000000000000000001111111111122222222222222223055555555555555500
00000000000000000000000000000000000000000004442224444444444440055555555555555500
00000000000000000000000000000000000000000044444444444000000000055555555555555500
00000000000000000000000000000000000000000044444444444000000000055555555555555500
00000000000000000000000000000000000000000044444444444000000000055555555555555500
00000000000000000000000000000000000000000044444444444000000000055555555555555500
00000000000000000000000000000000000000000044444444444000000000055555555555555500
00000000000000000000000000000000000000000044444444444000000000055555555555555500
00000000000000000000000000000000000000000044444444444000000000055555555555555500
00000000000000000000000000000000000000000044444444444000000000055555555555555500
00000000000000000000000000000000000000000044444444444000000000055555555555555500
00000000000000000000000000000000000000000004444444440000000000055555555555555500
00000000000000000000000000000000000000000000000000000000000000055555555555555500
00000000000000000000000000000000000000000000000000000000000000005555555555555000
00000000000000000000000000000000000000000000000000000000000000000000000000000000
00000000000000000000000000000000000000000000000000000000000000000000000000000000
00000000000000000000000000000000000000000000000000000000000000000000000000000000
00000000000000000000000000000000000000000000000000000000000000000000000000000000
00000000000000000000000000000000000000000000000000000000000000000000000000000000
00000000000000000000000000000000000000000000000000000000000000000000000000000000
00000000000000000000000000000000000000000000000000000000000000000000000000000000
00000000000000000000000000000000000000000000000000000000000000000000000000000000
00000000000000000000000000000000000000000000000000000000000000000000000000000000
00000000000000000000000000000000000000000000000000000000000000000000000000000000
00000000000000000000000000000000000000000000000000000000000000000000000000000000
00000000000000000000000000000000000000000000000000000000000000000000000000000000
00000000000000000000000000000000000000000000000000000000000000000000000000000000
00000000000000000000000000000000000000000000000000000000000000000000000000000000
00000000000000000000000000000000000000000000000000000000000000000000000000000000
00000000000000000000000000000000000000000000000000000000000000000000000000000000
00000000000000000000000000000000000000000000000000000000000000000000000000000000
00000000000000000000000000000000000000000000000000000000000000000000000000000000
00000000000000000000000000000000000000000000000000000000000000000000000000000000
00000000000000000000000000000000000000000000000000000000000000000000000000000000
00000000000000000000000000000000000000000000000000000000000000000000000000000000
